泛舟 横 大江L	南朝梁	萧纲	沧波 白日 晖 ， 游子 出 王畿L 。 旁望 重山 转 ， 前观 远帆 稀 。 广水 浮云 吹 ， 江风 引 夜衣 。 旅雁 同洲 宿 ， 寒凫 夹浦 飞 。 行客 谁 多病 ， 当念 早 旋归 。
望 江中 月 诗	南朝梁	萧绎	澄江L 涵 皓月 ， 水影 若 浮天 。 风来 如 可泛 ， 流急 不 成圆 。 秦钩 断 复接 ， 和璧 碎 还联 。 裂纨 依 岸草 ， 斜桂 逐 行船 。 即此 清江 上 ， 无俟 百枝 然 。
登 荆州城L 望江 二首	唐	张九龄	滔滔 大江L 水 ， 天地 相 终始 。 经阅 几世 人 ， 复叹 谁家 子 。 东望 何 悠悠 ， 西来 昼夜 流 。 岁月 既 如此 ， 为心 那 不愁 。
渡 扬子江L	唐	丁仙芝	桂楫 中流 望 ， 空波 两岸 明 。 林开 扬子驿L ， 山出 润州城L 。 海尽 边 阴静 ， 江寒 朔吹 生 。 更闻 枫叶 下 ， 淅沥 度 秋声 。
早发 白帝城L	唐	李白	朝辞 白帝L 彩云 间 ， 千里 江陵L 一日 还 。 两岸 猿声 啼 不住 ， 轻舟 已过 万重 山 。
登高	唐	杜甫	风急 天高 猿 啸哀 ， 渚清 沙白 鸟 飞回 。 无边 落木 萧萧 下 ， 不尽 长江L 滚滚 来 。 万里 悲秋 常 作客 ， 百年 多病 独 登台 。 艰难 苦恨 繁 霜鬓 ， 潦倒 新停 浊 酒杯 。
旅夜 书怀	唐	杜甫	细草 微风 岸 ， 危樯 独 夜舟 。 星垂 平野 阔 ， 月涌 大江L 流 。 名岂 文章 著 ， 官应 老病 休 。 飘飘 何 所似 ， 天地 一 沙鸥 。
晚渡 扬子江L 却 寄 江南L 亲故	唐	权德舆	返照 满 寒流 ， 轻舟 任 摇漾 。 支颐 见 千里 ， 烟景 非 一状 。 远岫 有无 中 ， 片帆 风水 上 。 天清 去鸟 灭 ， 浦回 寒沙 涨 。 树晚 叠 秋岚 ， 江空 翻 宿浪 。 胸中 千万 虑 ， 对此 一 清旷 。 回首 碧云 深 ， 佳人 不可 望 。
西江L 怀古	唐	杜牧	上吞 巴汉L 控 潇湘L ， 怒似 连山 静镜 光 。 魏帝P 缝囊 真 戏剧 ， 苻坚P 投棰 更 荒唐 。 千秋 钓舸 歌 明月 ， 万里 沙鸥 弄 夕阳 。 范蠡P 清尘 何 寂寞 ， 好风 唯属 往来 商 。
江行	唐	鱼玄机	大江L 横抱 武昌L 斜 ， 鹦鹉洲L 前 户 万家 。 画舸 春眠 朝 未足 ， 梦为 蝴蝶 也 寻花 。
初出 真州L 泛 大江L 作	北宋	欧阳修	孤舟 日日 去 无穷 ， 行色 苍茫 杳霭 中 。 山浦 转帆 迷 向背 ， 夜江 看斗 辨 西东 。 滮田 渐下 云间 雁 ， 霜日 初丹 水上 枫 。 莼菜 鲈鱼 方 有味 ， 远来 犹喜 及 秋风 。
泊船 瓜洲L	北宋	王安石	京口L 瓜洲L 一水 间 ， 钟山L 只隔 数重 山 。 春风 又绿 江南 岸 ， 明月 何时 照 我 还 。
卜算子 · 我住 长江L 头	宋	李之仪	我住 长江L 头 ， 君住 长江L 尾 。 日日 思君 不见 君 ， 共饮 长江L 水 。 此水 几时 休 ， 此恨 何时 已 。 只愿 君心 似 我心 ， 定 不负 相思 意 。
六么令 · 次韵 和 贺方回P 金陵L 怀古 鄱阳L 席上 作	宋	李纲	长江L 千里 ， 烟淡 水云 阔 。 歌沈 玉树 ， 古寺 空有 疏钟 发 。 六代 兴亡 如梦 ， 苒苒 惊 时月 。 兵戈 凌灭 。 豪华 销尽 ， 几见 银蟾 自 圆缺 。 潮落 潮生 波渺 ， 江树 森 如发 。 谁念 迁客 归来 ， 老大 伤 名节 。 纵使 岁寒 途远 ， 此志 应 难夺 。 高楼 谁设 。 倚阑 凝望 ， 独立 渔翁 满 江雪 。
登 金陵L 雨花台L 望 大江L	明	高启	大江L 来从 万山 中 ， 山势 尽与 江流 东 。 钟山L 如龙 独 西上 ， 欲破 巨浪 乘 长风 。 江山 相雄 不 相让 ， 形胜 争夸 天下 壮 。 秦皇P 空此 瘗 黄金 ， 佳气 葱葱 至 今王 。
长江L 万里 图	明	杨基	我家 岷山L 更西 住 ， 正见 岷江L 发源 处 。 三巴L 春霁 雪 初消 ， 百折 千回 向东 去 。 江水 东流 万里 长 ， 人今 漂泊 尚 他乡 。 烟波 草色 时 牵恨 ， 风雨 猿声 欲 断肠 。
九日 渡江	明	李东阳	秋风 江口 听 鸣榔 ， 远客 归心 正 渺茫 。 万里 乾坤 此 江水 ， 百年 风日 几 重阳 。 烟中 树色 浮 瓜步L ， 城上 山形 绕 建康L 。 直过 真州L 更 东下 ， 夜深 灯影 宿 维扬L 。
临江仙 · 滚滚 长江L 东逝 水	明	杨慎	滚滚 长江L 东逝 水 ， 浪花 淘尽 英雄 。 是非 成败 转头 空 。 青山 依旧 在 ， 几度 夕阳 红 。 白发 渔樵 江渚 上 ， 惯看 秋月 春风 。 一壶 浊酒 喜 相逢 。 古今 多少 事 ， 都付 笑谈 中 。
中元节 自 黄浦L 出 吴淞L 泛海	清	陈去病	舵楼 高唱 大江L 东 ， 万里 苍茫 一览 空 。 海上 波涛 回荡 极 ， 眼前 洲渚 有无 中 。 云磨 雨洗 天 如碧 ， 日炙 风翻 水 泛红 。 唯有 胥涛 若 银练 ， 素车 白马 战 秋风 。
渡 黄河L	南朝	范云	河流 迅 且 浊 ， 汤汤 不可 陵 。 桧楫 难 为榜 ， 松舟 才 自胜 。 空庭 偃 旧木 ， 荒畴 余 故塍 。 不睹 行人 迹 ， 但见 狐兔 兴 。 寄言 河上 老 ， 此水 何当 澄 ？
登 鹳雀楼L	唐	王之涣	白日 依山 尽 ， 黄河L 入海 流 。 欲穷 千里 目 ， 更上 一层 楼 。
砥柱山L 铭	唐	魏征	仰临 砥柱L ， 北望 龙门L 。 茫茫 禹迹L ， 浩浩 长春L 。
公无 渡河	唐	李白	黄河L 西来 决 昆仑L ， 咆哮 万里 触 龙门L 。 波 滔天 ， 尧 咨嗟 。 大禹P 理 百川 ， 儿啼 不 窥家 。 杀湍 湮 洪水 ， 九州 始 蚕麻 。 其害 乃去 ， 茫然 风沙 。
西岳L 云台 歌 送 丹丘子P	唐	李白	西岳L 峥嵘 何 壮哉 ！ 黄河L 如丝 天际 来 。 黄河L 万里 触山 动 ， 盘涡 毂转 秦地 雷 。 荣光 休气 纷 五彩 ， 千年 一清 圣人 在 。 巨灵 咆哮 擘 两山 ， 洪波 喷箭 射 东海 。
行路难 · 其一	唐	李白	金樽 清酒 斗 十千 ， 玉盘 珍羞 直 万钱 。 停杯 投箸 不能 食 ， 拔剑 四顾 心 茫然 。 欲渡 黄河L 冰 塞川 ， 将登 太行L 雪 满山 。 闲来 垂钓 碧溪 上 ， 忽复 乘舟 梦 日边 。 行路 难 ！ 行路 难 ！ 多 歧路 ， 今 安在 ？ 长风 破浪 会 有时 ， 直挂 云帆 济 沧海 。
自 巩洛L 舟行 入 黄河L 即事 ， 寄 府县 僚友	唐	韦应物	夹水 苍山 路 向东 ， 东南 山豁 大河 通 。 寒树 依微 远天 外 ， 夕阳 明灭 乱流 中 。 孤村 几岁 临 伊岸 ， 一雁 初晴 下 朔风 。 为报 洛桥L 游宦 侣 ， 扁舟 不系 与心 同 。
浪淘沙 · 九曲 黄河L 万里 沙	唐	刘禹锡	九曲 黄河L 万里 沙 ， 浪淘 风簸 自 天涯 。 如今 直上 银河 去 ， 同到 牵牛 织女 家 。
黄河L 八韵 寄呈 圣俞L	宋	欧阳修	河水 激 箭险 ， 谁言 航 苇游 。 坚冰 驰马 渡 ， 伏浪 卷沙 流 。 树落 新 摧岸 ， 湍惊 忽 改洲 。 凿龙 时 退鲤 ， 涨潦 不 分牛 。 万里 通 槎汉 ， 千帆 下 漕舟 。 怨歌 今 罢筑 ， 故道 失 难求 。 滩急 风 逾响 ， 川寒 雾 不收 。 谈能 穷 禹迹L ， 空欲 问 张侯P 。
依韵 和 欧阳永叔P 黄河L 八韵	宋	梅尧臣	少本 江南L 客 ， 今为 河曲L 游 。 岁时 忧 漾溢 ， 日夕 见 奔流 。 啮岸 侵 民壤 ， 飘槎 阁 雁洲 。 峻门 波 作箭 ， 古郡 铁 为牛 。 目极 高飞 鸟 ， 身轻 不及 舟 。
渡河	宋	黄庭坚	客行 岁晚 非 远游 ， 河水 无情 日夜 流 。 去年 排堤 注 东郡L ， 诏使 夺河 还 此州 。 忆昔 冬行 河梁 上 ， 飞雪 千里 曾 冰壮 。 人言 河源L 冻 彻天 ， 冰底 犹闻 沸 惊浪 。
渡 黄河L	明	谢榛	路出 大梁城L ， 关河 开 晓晴 。 日翻 龙窟 动 ， 风扫 雁沙 平 。 倚剑 嗟 身事 ， 张帆 快 旅情 。 茫茫 不知 处 ， 空外 棹歌 声 。
秋望	明	李梦阳	黄河L 水绕 汉宫 墙 ， 河上 秋风 雁 几行 。 客子 过壕 追 野马 ， 将军 韬箭 射 天狼 。 黄尘 古渡 迷 飞挽 ， 白月 横空 冷 战场 。 闻道 朔方 多 勇略 ， 只今 谁是 郭汾阳P 。
宁夏L 渡河	清	黄庭	峡口 回波 绕塞 流 ， 黄河L 利独 擅 边州L 。 千屯 得水 成 膏壤 ， 两坝 分渠 据上 游 。 鸡犬 人家 红稻 岸 ， 鱼盐 贾舶 白蘋洲 。 那知 泽国 堤防 急 ， 百万 金钱 掷 浪头 。
饮马 长城L 窟 行	魏晋	陈琳	饮马 长城L 窟 ， 水寒 伤 马骨 。 往谓 长城L 吏 ， 慎莫 稽留 太原L 卒 ！ 官作 自 有程 ， 举筑 谐 汝声 ！ 男儿 宁当 格斗 死 ， 何能 怫郁 筑 长城L 。 长城L 何 连连 ， 连连 三千 里 。 边城 多 健少 ， 内舍 多 寡妇 。 君独 不见 长城L 下 ， 死人 骸骨 相 撑拄 。
胡笳 十八 拍	汉	蔡文姬	冰霜 凛凛 兮 身 苦寒 ， 饥对 肉酪 兮 不能 餐 。 夜间 陇水L 兮 声 呜咽 ， 朝见 长城L 兮 路 杳漫 。 追思 往日 兮 行李 难 ， 六拍 悲来 兮 欲 罢弹 。
饮马 长城L 窟 行 示 从征 群臣	隋	杨广	肃肃 秋风 起 ， 悠悠 行 万里 。 万里 何 所行 ， 横漠 筑 长城L 。 岂台 小子 智 ， 先圣 之 所营 。 树兹 万世 策 ， 安此 亿 兆生 。
饮马 长城L 窟 行	唐	李世民	塞外 悲风 切 ， 交河L 冰 已结 。 瀚海L 百重 波 ， 阴山L 千里 雪 。 迥戍 危 烽火 ， 层峦 引 高节 。 悠悠 卷 旆旌 ， 饮马 出 长城L 。 寒沙 连 骑迹 ， 朔吹 断 边声 。 胡尘 清 玉塞 ， 羌笛 韵 金钲 。 绝漠 干戈 戢 ， 车徒 振 原隰 。 都尉 反 龙堆L ， 将军 旋 马邑L 。 扬麾 氛雾 静 ， 纪石 功名 立 。 荒裔 一 戎衣 ， 云台L 凯歌 入 。
北风 行	唐	李白	燕山L 雪花 大 如席 ， 片片 吹落 轩辕台L 。 幽州L 思妇 十二 月 ， 停歌 罢笑 双蛾 摧 。 倚门 望 行人 ， 念君 长城L 苦寒 良 可哀 。
寄 哥舒仆射P	唐	韩翃	万里 长城L 家 ， 一生 唯 报国 。 腰垂 紫文绶 ， 手控 黄金勒 。 高视 黑头翁 ， 遥吞 白骑贼 。 先麾 牙门将 ， 转斗 黄河L 北 。
雁门L 太守 行	唐	李贺	黑云 压城 城 欲摧 ， 甲光 向日 金鳞 开 。 角声 满天 秋色 里 ， 塞上 燕脂 凝 夜紫 。 半卷 红旗 临 易水L ， 霜重 鼓寒 声 不起 。 报君 黄金台L 上 意 ， 提携 玉龙 为君 死 。
塞下 曲	唐	王昌龄	饮马 渡 秋水 ， 水寒 风 似刀 。 平沙 日 未没 ， 黯黯 见 临洮L 。 昔日 长城L 战 ， 咸言 意气 高 。 黄尘 足 今古 ， 白骨 乱 蓬蒿 。
出塞	唐	王昌龄	秦时 明月 汉时 关 ， 万里 长征 人 未还 。 但使 龙城L 飞将 在 ， 不教 胡马 度 阴山L 。
从军 行	唐	王昌龄	琵琶 起舞 换 新声 ， 总是 关山L 旧 别情 。 撩乱 边愁 听 不尽 ， 高高 秋月 照 长城L 。
使至 塞上	唐	王维	单车 欲 问边 ， 属国 过 居延L 。 征蓬 出 汉塞 ， 归雁 入 胡天 。 大漠 孤烟 直 ， 长河L 落日 圆 。 萧关L 逢 候骑 ， 都护 在 燕然L 。
相和 歌辞·饮马 长城L 窟行	唐	王翰	回来 饮马 长城L 窟 ， 长安L 道傍 多 白骨 。 问之 耆老 何代 人 ， 云是 秦王L 筑城 卒 。 秦王L 筑城 何 太 愚 ， 天实 亡秦 非 北胡 。 一朝 祸起 萧墙 内 ， 渭水L 咸阳L 不复 都 。
长城L	唐	汪遵	秦筑 长城L 比 铁 牢 ， 蕃戎 不敢 过 临洮L 。 虽然 万里 连 云际 ， 争及 尧阶 三尺 高 。
望 江南 · 春睡 起	南宋	金德淑	春睡 起 ， 积雪 满 燕山L 。 万里 长城L 横 玉带 ， 六街 灯火 已 阑珊 ， 人立 蓟楼 间 。
长城L	明	陈颢	漠漠 黄沙 万里 城 ， 昔人 曾此 驻 秦兵 。 旌旗 影动 胡尘 没 ， 笳鼓 声寒 塞月 明 。 马邑L 荒烟 迷 故堞 ， 雁门L 残火 照 颓营 。 谁知 再世 归 隆准P ， 长使 英雄 泪 满缨 。
塞垣L 鹧鸪 词	明	杨慎	秦时 明月 玉弓 悬 ， 汉塞 黄河L 锦带 连 。 都护 羽书 飞 翰海L ， 单于 猎火 照 甘泉L 。 莺闺 燕阁 年 三五 ， 马邑L 龙堆L 路 十千 。 谁起 东山L 安石P 卧 ， 为君 谈笑 靖 烽烟 。
饮马 长城L 窟	清	傅昂霄	君 不见 长城L 之北 青海L 边 ， 平沙 直上 黄 云天 ， 沙中 白骨 堆 何年 ？ 阴山L 九月 风 怒号 ， 风吹 戍火 连云高 。 云中L 五原L 军 出幕 ， 左贤 右贤 心胆 落 ， 军中 大将 闻 姓霍 。 鼓声 如雷 笳声 死 ， 冒围 脱走 天 骄子 。 烽烟 一扫 万里 秋 ， 汉家 天子 恩 未酬 ， 男儿 何用 言 封侯 。 太白 蚀月 旄头 没 ， 归来 饮马 长城L 窟 。
长城L	清	德保	长城L 设险 势 方豪 ， 空忆 亡羊 尚 补牢 。 但使 雄关 分 内外 ， 遂教 沧海 动 波涛 。 金墉 不解 萧墙 患 ， 粉堞 曾同 束马 劳 。 千古 人来 城上 望 ， 笑他 坚垒 敌 弓刀 。
长城L	清	范大元	骄虏 昔 未平 ， 秦墙 紫塞L 横 。 舆图 今 万里 ， 不必 限 长城L 。
登 万里 长城L	清	康有为	秦时 楼堞 汉家 营 ， 匹马 高秋 抚 旧城 。 鞭石 千峰 上 云汉 ， 连天 万里 压 幽并L 。 东穷 碧海 群山 立 ， 西带 黄河L 落日 明 。 且勿 却胡 论 功绩 ， 英雄 造事 令人 惊 。
出军 歌	清	黄遵宪	绵绵 翼翼 万里 城 ， 中有 五岳L 撑 。 黄河L 浩浩 流水 声 ， 能令 海若 惊 。 东西 禹步 横 庚庚 ， 行 行 行 ！
望 蓟门L	唐	祖咏	燕台L 一望 客 心惊 ， 箫鼓 喧喧 汉将 营 。 万里 寒光 生 积雪 ， 三边 曙色 动 危旌 。 沙场 烽火 连 胡月 ， 海畔 云山 拥 蓟城L 。 少小 虽非 投 笔吏 ， 论功 还欲 请 长缨 。
蓟门L 烟树	明	金幼孜	野色 苍苍 接 蓟门L ， 淡烟 疏树 碧 氤氲 。 过桥 酒幔 依稀 见 ， 附郭 人家 远近 分 。 翠雨 落花 行处 有 ， 绿阴 啼鸟 坐来 闻 。 玉京 尽日 多 佳气 ， 缥缈 还看 映 五云 。
蓟门L 烟树	明	邹缉	古城 西北 蓟门L 前 ， 望见 郊畿 树 似烟 。 十里 清阴 遥 带郭 ， 万株 浓绿 上 参天 。 行人 歇马 偏 留愒 ， 游客 听莺 每 见怜 。 几度 更看 摇落 处 ， 长吟 惟是 夕阳 边 。
蓟门L 烟树	明	李东阳	蓟丘城L 外 访 遗纵 ， 树色 烟光 远 更重 。 飞雨 过时 青 未了 ， 落花 残处 绿 还浓 。 路迷 南郭 将 三里 ， 望断 西林 有 数峰 。 坐久 不知 迟 日霁 ， 隔溪 僧寺 午时 钟 。
燕京L 八景	清	无名氏	银桥 观山 隐约 间 ， 金台L 夕照 玉 生烟 。 居庸L 叠翠 三边 好 ， 琼岛L 春荫 二月 间 。 太液L 清波 情 不尽 ， 卢沟L 晓月 月 阑珊 。 蓟门L 烟雨 空 余树 ， 玉泉L 垂虹 八景 全 。
登 幽州台L 歌	唐	陈子昂	前 不见 古人 ， 后 不见 来者 。 念 天地 之 悠悠 ， 独 怆然 而 涕下 ！
蓟丘L 览古	唐	陈子昂	南登 碣石坂L ， 遥望 黄金台L 。 丘陵 尽 乔木 ， 昭王P 安在 哉 。 霸图 怅 已矣 ， 驱马 复 归来 。
金明池 · 燕台L 怀古 和 申隨叔翰林P	清	朱彝尊	西园 妆楼 ， 南城 猎骑 ， 几处 笳吹 芦叶 ？ 孤鸟 外 、 生烟 夕照 ， 对 千里 万里 积雪 。 更 谁来 击筑 高阳L ？ 但 满眼 花豹 明驼 相接 。 剩 野火 楼桑L ， 秋尘 石鼓 ， 陌上 行人 空说 。 战斗 渔阳L 何曾 歇 ？ 笑古 往今 来 ， 浪传 豪杰 。 绿头鸭 悲吟 乍了 ， 白翎雀 醉歌 还阕 。 数 燕云 十六 神州 ， 有 多少 园陵 ， 颓垣 断碣 。 正 石马 嘶残 ， 金仙 泪尽 ， 古水 荒沟 寒月 。
金台L 夕照	明	邹缉	高台 百尺 倚 都城 ， 斜日 苍茫 异 晚晴 。 千里 江山 回望 迥 ， 万家 楼阁 入 空明 。 黄金L 尚想 招贤 意 ， 白发 难胜 慨 古情 。 看尽 翩翩 归鸟 没 ， 古原 秋草 暮 方平 。
都城 郊望	明	岳正有	神鼎 当年 定 蓟门L ， 舆图 徧览 此 方尊 。 天文 析木 三河 近 ， 王气 全燕 万古 存 。 水绕 郊畿 襟带 合 ， 山环 宫阙 虎龙 蹲 。 何须 百二 夸 周汉 ， 一统 今归 圣 子孙 。
帝京 诗	明	王廷相	帝京 南面 俯 中原 ， 王气 千秋 涌 蓟门L 。 渤海L 东波 连 肃慎L ， 太行L 西脊 引 昆仑L 。 九皇 天运 坤维 奠 ， 万国 星罗 北极 尊 。 尧舜P 升平 见 今日 ， 按图 形胜 不须 论 。
苑中 五色 鹤 斑然 可异 ， 归 而 赋	明	朱翊钧	常停 游宴 五谷 丰 ， 坐奏 箫韶 百兽 喜 。 五十 年 来 称 太平 ， 奕叶 休光 庆 此生 。 愿同 驯鸟 呈 歌舞 ， 岁岁 遨游 佳丽城L 。
清宫词 · 春殿 宴	清	魏程搏	和风 丽日 遍 遐陬 ， 万姓 胪欢 喜 若雷 。 欲纪 升平 春殿 宴 ， 赋诗 仍是 柏梁台L 。
珍妃 井	清	高树	古井 无波 送 洛妃 。 袞龙 易去 出 宫闱 。 伤心 误陷 奸人 计 ， 甘作 咸阳L 一 布衣 。
西苑L	清	李希圣	芙蓉 别殿 锁 瀛台L ， 落叶 鸣蝉 尽日 哀 。 宝帐 尚留 琼岛L 药 ， 金釭 空照 玉阶 苔 。 神仙 已遣 青鸾 去 ， 瀚海L 仍闻 白雁 来 。 莫问 禁垣 芳草 地 ， 箧中 秋扇 已 成灰 。
秋日 登 观象台L 望 故宫L 及 功臣庙L 一带 遗址	明	黄周星	独来 独往 意 何如 ， 羁客 心孤 意 不孤 。 落日 河山 千古 在 ， 秋风 天地 一人 无 。 英雄 感慨 麒麟阁L ， 神鬼 睥睨 燕雀 湖 。 高处 不须 搔首 问 ， 碧翁 大事 久 糊涂 。
题 景山L 挂图	清	爱新觉罗·溥杰	两代 故宫L 称 别苑 ， 五亭 珠贯 势 犹龙 。 兆烝 今日 供 游骋 ， 笑指 煤山L 傍 麓松 。
景山L 春望	清	爱新觉罗·玄烨	云霄 千尺 倚 丹邱L ， 辇下 山河 一望 收 。 凤翥 中天 连 紫阙L ， 龙蟠 北极 壮 皇州L 。 烟生 沆瀣 春 初丽 ， 露湿 芙蓉 翠 欲流 。 却向 闾阎 看 蔀屋 ， 崇高 还廑 庙堂 忧 。
读 崇祯P 辛未 后 十余 年 事	清	萧正模	心匪 不仁 计 则穷 ， 减夫 派饷 事 重重 。 可怜 三百 年 天下 ， 断送 忧勤 惕厉 中 。
太液L 晴波	明	邹缉	万顷 溶溶 太液池L ， 水纹 如縠 叠 清漪 。 春生 蘋藻 浮 香气 ， 暖泛 凫鸥 散 羽仪 。 风细 锦堤 龙影 动 ， 云开 玉甃 日光迟 。 年年 上日 宸游 处 ， 鱼鸟 应随 采仗 移 。
太液L 晴波	明	杨荣	太液L 晴涵 一 镜 开 ， 溶溶 漾漾 自 天 来 。 光浮 雪练 明 金阙 ， 影带 晴虹 绕 玉台 。 萍藻 摇风 仍 荡漾 ， 龟鱼 向日 共 徘徊 。 蓬莱L 咫尺 沧溟 上 ， 瑞气 氤氲 接 上台 。
游 琼华岛L 四首	元	王恽	蓬莱L 云气 海 中央 ， 薰彻 琼华L 露 影香 。 一炬 忽收 天上 去 ， 谩从 焦土 说 阿房L 。
琼华岛L	明	文征明	海上 三山 拥 翠鬟 ， 天宫 遥在 碧云 端 。 古来 漫说 琼台L 迥 ， 人事 宁知 玉宇L 寒 ？ 落日 芙蓉 烟 袅袅 ， 秋风 桂树 露 团团 。 胜游 寂寞 前朝 事 ， 谁见 吹箫 驾 彩鸾 ？
水殿	明	文征明	别殿 阴阴 水窦 连 ， 汉家 帝子 有 楼船 。 兰桡 桂楫 曾 千古 ， 锦缆 牙樯 忆 往年 。 汾水L 秋风 空 落日 ， 隋堤 杨柳 漫 生烟 。 今皇 别有 同民 乐 ， 不遣 青龙 漾 碧川 。
琼岛L 春阴	清	爱新觉罗·弘历	艮岳L 移来 石 嵯峨 ， 千秋 遗迹 感怀 多 。 倚岩 松翠 龙鳞 蔚 ， 入牖 篁新 凤尾 娑 。 乐志 讵因 逢 胜赏 ， 悦心 端为 得 嘉禾 。 当春 最是 耕犁 急 ， 每较 阴晴 发 浩歌 。
北海L	清	爱新觉罗·溥杰	金鳌玉栋L 古桥 头 ， 修竹 千竿 百尺 楼 。 白塔L 耸云 悬 曲径 ， 画廊 环月 枕 漪流 。 缅怀 五代 余 轮奂 ， 兹快 平生 豁 眼眸 。 指顾 酒帘 偏 引兴 ， 临风 高踞 醉 琼瓯 。 隔尘 入胜 别 天地 ， 继续 蝉吟 日 正长 。 环簇 翠苍 巍 玉塔L ， 镜涵 漪潋 引 雕廊 。 桥分 柳岸 浓 秋色 ， 人棹 荷风 浥 晚凉 。 最动 客情 看 不足 ， 九龙 蟠壁 萃 琳琅 。
天坛L 松月	清	戴梓	深夜 冷 溶溶 ， 圜丘 露气 浓 。 月明 时绕 雀 ， 松老 欲 成龙 。 古殿 浮 空翠 ， 晴山 落 远钟 。 当年 禋祀 地 ， 短草 乱 遗踪 。
凤城L 春柳 词	清	陈文述	城南 韦曲L 访 名园 ， 烟景 迷离 隔水 看 。 记得 春游 曾 拾翠 ， 红泥 亭子 碧 阑干 。
陶然亭L	清	龚自珍	楼阁 参差 未 上灯 ， 菰芦 深处 有人 行 。 凭君 且莫 登高 望 ， 忽忽 中原 暮霭 生 。
雨后 昆明湖L 泛舟 骋望	清	爱新觉罗·弘历	半夜 嘉霖 晓 快晴 ， 敕机 暇偶 泛 昆明L 。 稳同 天上 坐 春水 ， 爽学 秋风 动 石鲸 。 出绿 柳荫 知 岸远 ， 入红 莲路 荡舟 轻 。 玉峰 真似 蓬莱岛L ， 只许 遥遥 镜里 呈 。
昆明湖L 泛舟	清	爱新觉罗·弘历	何处 燕山L 最 畅情 ， 无双 风月 属 昆明L 。 侵肌 水色 夏 无暑 ， 快意 天容 雨 正晴 。 倒影 山 当 波底 见 ， 分流 稻 接 垸边 生 。 披襟 清永 饶 真乐 ， 不藉 仙踪 问 石鲸 。
浪淘沙·登 香山L 望 昆明湖L	清	顾太清	碧瓦 指 离宫 ， 楼阁 飞崇 。 遥看 草色 有无 中 。 最是 一年 春好 处 ， 烟柳 空濛 。 湖水 自 流东 ， 桥影 垂虹 。 三山 秀气 为谁 钟 。 武帝P 旌旗 都 不见 ， 盛世 难逢 。
使 青夷 军 入 居庸L 三首	唐	高适	匹马 行 将久 ， 征途 去 转难 。 不知 边地 别 ， 只讶 客 衣单 。 溪冷 泉声 苦 ， 山空 木叶 干 。 莫言 关塞 极 ， 云雪 尚 漫漫 。
过 居庸关L	宋	宇文虚中	奔峭 从天 拆 ， 悬流 赴壑 清 。 路回 穿 石细 ， 崖裂 与藤 争 。 花已 从南 发 ， 人今 又 北行 。 节旄 都 落尽 ， 奔走 愧 平生 。
九月一日T 还自 上京L 途中 纪事	元	周伯琦	北口 七十二 ， 居庸L 第一 关 。 峭崖 屏 列翠 ， 急涧 玉 鸣环 。 佛阁 腾 云雾 ， 人家 结 市闤 。 马前 军吏 候 ， 使节 几时 还 。
居庸L 叠翠	元	陈孚	断崖 万仞 如 削铁 ， 鸟飞 不渡 苔石 裂 。 嵯岈 枯木 无 碧柯 ， 六月 太阴 飘 急雪 。 塞沙 茫茫 出关 道 ， 骆驼 夜吼 黄云 老 。 征鸿 一声 起 长空 ， 风吹 草低 山月 小 。
居庸关L	明	王英	千峰 高处 起 层城 ， 空里 岧峣 积 翠明 。 云静 芙蓉 开 霁色 ， 天清 鼓角 散 秋声 。 北连 紫塞L 烽烟断 ， 南接 金台L 驿路平 。 此地 由来 称 设险 ， 万年 形势 壮 神京L 。
榆河L 晓发	明	谢榛	朝晖 开 众山 ， 遥见 居庸关L 。 云出 三边 外 ， 风生 万马 间 。 征尘 何日 静 ， 古戍 几人 闲 。 忽忆 弃繻 者 ， 空惭 旅 鬓斑 。
出关	清	徐兰	凭山 俯海 古 边州L ， 旆影 风翻 见 戍楼 。 马后 桃花 马前 雪 ， 出关 争得 不 回头 。
居庸关L	清	顾炎武	居庸L 突兀 倚 青天 ， 一涧 泉流 鸟道 悬 。 终古 戍兵 烦 下口L ， 本朝 陵寝 托 雄边 。 车穿 褊峡 鸣禽 里 ， 烽点 重冈 落雁 前 。 燕代 经过 多 感慨 ， 不关 游子 思 风烟 。
入 居庸关L	清	爱新觉罗·玄烨	始和 羽骑 出 重关L ， 风动 南熏 整旆 还 。 凯奏 捷书 传 朔塞 ， 欢声 喜气 满 人寰 。 悬崖 壁立 垣墉L 固 ， 古峡 泉流 昼夜 间 。 须识 成城 惟 众志 ， 称雄 不独 峙 群山 。
西出 居庸关L	清	陈璋	西出 雄关 路 屈盘 ， 风云 重接 旧 征鞍 。 山如 屏合 窥天 小 ， 水作 虹流 入耳 寒 。 万里 女墙 连 雁塞L ， 百年 兵甲 洗 桑乾L 。 太平 气象 无 中外 ， 镇朔台L 高 立马 看 。
过 昌平城L 望 居庸关L	清	康有为	城堞 逶迤 万柳 红 ， 西山L 岧嵽 霁 明虹 。 云垂 大野 鹰盘 势 ， 地展 平原 骏走 风 。 永夜 驼铃 传 塞上 ， 极天 树影 递 关东 。 时平 堡堠 生 青草 ， 欲出 军都L 吊 鬼雄 。
塞上	明	李梦阳	天设 居庸L 百二关 ， 祁连L 更隔 万重 山 。 不知 谁放 呼延 入 ， 昨日 杨河L 大战 还 。
弹琴峡L	明	杨士奇	峡石 记 弹琴 ， 泠泠 流水 音 。 不知 行路 者 ， 谁有 听琴 心 。
弹琴峡L	元	陈孚	月 作 金徽 风 作 弦 ， 清声 岂待 指中 弹 ？ 伯牙P 别有 高山 调 ， 写在 松风 乱石 间 。
巡边	明	杨选	潮河L 潮河L ， 流迫 山河 ， 中有 嗟呀 之 巨石 ， 旁倚 峻嶝 之 危坡 。 长垣L 占乎 重隘 ， 铁垒 肃乎 金戈 ， 虏兮 虏兮 奈 如何 ！
古北口L	清	顾炎武	雾灵山L 上 杂花 生 ， 山下 流泉 入塞 声 。 却恨 不逢 张少保L ， 碛南L 犹筑 受降 城 。
回銮 抵 古北口L	清	爱新觉罗·玄烨	黄谷 清河 古戍 间 ， 銮车 此日 省 方还 。 长林 曲抱 千溪 水 ， 小径 斜通 万仞 山 。 地扼 襟喉 趋 朔漠L ， 天留 锁钥 枕 雄关 。 时平 不用 夸 形胜 ， 云物 秋澄 斥候 闲 。
古北口L 中秋	清	曹寅	山苍 水白 卧牛 城 ， 三尺 黄旗 万马 鸣 。 半夜 澶州L 看 秋月 ， 河山 表里 更 分明 。
古北口L	清	纳兰性德	乱山 入戟 拥 孤城 ， 一线 人争 鸟道 行 。 地险 东西 分 障塞 ， 云开 南北 望 神京L 。 新图 已入 三关L 志 ， 往事 休论 十路 兵 。 都护 近来 长 不调 ， 年年 烽火 报 生平 。
古北口L	清	顾陈垿	地险 雄关 旧 ， 秋临 独 客惊 。 马头 悬 汉月 ， 山背 络 秦城 。 草带 烽烟 色 ， 蝉为 朔吹 声 。 舆图 正 无外 ， 大漠 亦 神京L 。
登 八达岭L	清	沈用济	策马 出 居庸L ， 盘回 上 碧峰 。 坐窥 京邑L 尽 ， 行绕 塞垣L 重 。 夕照 沉 千帐 ， 寒声 折 万松 。 回瞻 陵寝 地 ， 云气 总 成龙 。
八达岭L	明	徐渭	八达L 高坡 百尺 强 ， 迳连 大漠 去 荒荒 。 舆幢 尽日 山 油碧 ， 戍堡 终年 雾 噀黄 。
登万里 长城L	清	康有为	汉时 关塞 重 卢龙L ， 立马 长城L 第一 峰 。 日暮 长河L 盘 大漠 ， 天晴 外部 数疆 封 。 清时 堡堠 传峰 静 ， 出塞 山川 作 势雄 。 百万 控弦 嗟 往事 ， 一鞭 冷月 踏 居庸L 。
香山L	金	周昂	山林 朝市 两 茫然 ， 红叶 黄花 自 一川 。 野水 趁人 如 有约 ， 长松 阅世 不知 年 。 千篇 未暇 偿 诗债 ， 一饭 聊从 结 净缘 。 欲问 安心 心 已了 ， 手书 谁识 是 生前 。
游 香山L	元	张养浩	常恐 尘坋 汩 寸心 ， 好山 时复 一 登临 。 长风 将月 出 沧海 ， 老柏 与云 藏 太阴 。 宝刹 千间 穷 土木 ， 残碑 一片 失 辽金 。 丹崖 不用 题 名姓 ， 俯仰 人间 又 古今 。
香山L 月夜	清	王士祯	明月 出 东岭 ， 诸峰 方 悄然 。 残雪 尚 在地 ， 掩映 西斋 前 。 竹色 既 闲静 ， 松阴 媚 沦涟 。 清晖 一 相照 ， 万象 皆 澄鲜 。 此时 憩寂 者 ， 宵分 犹 未眠 。
暮行 香山L 道中	清	丘齐云	出郭 寻 萧寺 ， 偏缘 芳草 行 。 溪深 云 落雨 ， 山远 树 为城 。 一径 一 花色 ， 无时 无 鸟声 。 不知 湖上 月 ， 飞向 马头 明 。
题 香山寺L 画卷	元	王恽	送客 当年 过 玉泉L ， 醉中 游赏 得 奇观 。 一泓 湛碧 浮 僧钵 ， 几叶 秋黄 打 石阑 。 山色 空濛 金界 湿 ， 松声 清泛 海波 寒 。 吟鞭 回首 都门 道 ， 斜日 归时 翠 满鞍 。
碧云寺L	明	文征明	翠殿 朱扉 翔 紫清 ， 璇题 金榜 日 晶晶 。 青莲 宛转 开 天界 ， 玉阙 分明 作 化城 。 双涧 循除 鸣 佩玦 ， 三花 拂槛 映 幡旌 。 贵人 一去 无 消息 ， 野老 依稀 识 姓名 。
碧云寺L	明	陶允嘉	金风 猎猎 吹 远松 ， 青霞 朵朵 生 残峰 。 西山L 一径 三百 寺 ， 唯有 碧云L 称 纤秾 。
初冬 夜 同 李伯承P 过 碧云寺L	明	谢榛	并马 寻 名寺 ， 登高 藉 短筇 。 飞泉 鸣 古涧 ， 落月 在 寒松 。 石路 经 千转 ， 云岩 复 几重 。 人间 多 梦寐 ， 谁听 上方钟 。
碧云寺L	清	王士祯	入寺 闻 山雨 ， 群峰 方 夕阳 。 流泉 自 成响 ， 林壑 坐 生凉 。 竹覆 春前 雪 ， 花寒 劫外 香 。 汤休P 何处 是 ， 空望 碧云L 长 。
碧云寺L	明	钱谦益	丹青 台殿 起 层层 ， 玉磶 雕阑 取 次登 。 禁近 恩波 蒙 葬地 ， 内家 香火 傍 禅灯 。 丰碑 巨刻 书 元宰 ， 碧海 红尘 问 老僧 。 礼罢 空王 三 叹息 ， 自穿 萝径 拄 孤藤 。
玉泉山L	明	胡广	玉泉L 之山 下 出泉 ， 泉流 树色 镜中 悬 。 却带 西湖L 连 内苑 ， 直下 通津 先 百川 。
玉泉山L	明	曾棨	跳珠 溅玉 出岩 多 ， 尽日 寒声 洒 薜萝 。 秋影 涵空 翻 雪练 ， 晓光 横野 落 银河 。 潺潺 旧绕 芙蓉殿L ， 漾漾 今生 太液L 波 。 更待 西湖L 春浪 阔 ， 尊罍 再听 濯缨 歌 。
西山L	元	马祖常	凤城L 西去 玉泉L 头 ， 杨柳 堤长 马上 游 。 六月 熏风 吹 别殿 ， 半天 飞雨 洒 重楼 。 山浮 树盖 连云 动 ， 露滴 荷盘 并水 流 。 舣岸 龙舟 能 北望 ， 翠华 来日 正 清秋 。
西山L 道中	明	刘大夏	晓来 联骑 踏 晴沙 ， 风景 苍苍 一望 赊 。 几处 白云 前代 寺 ， 数村 流水 野 人家 。 莺啼 别墅 春 犹在 ， 马到 西山L 日 未斜 。 回首 不知 归路 远 ， 九重 宫殿 隔 烟霞 。
西山L	明	李东阳	日日 车尘 马足 间 ， 梦魂 连夜 到 西山L 。 近郊 地在 翻 成远 ， 出郭 身来 始 是闲 。 云里 荡胸 看 缥缈 ， 溪边 洗耳 听 潺湲 。 秋风 忽散 城头 雨 ， 先为 游人 一 解颜 。
西山L	清	刘大櫆	西山L 过雨 染 朝岚 ， 千尺 平冈 百顷 潭 。 啼鸟 数声 深树 里 ， 屏风 十幅 写 江南L 。
翠微寺L	明	廖希颜	翠微L 西接 古 神州L ， 石磴 云盘 阁道 幽 。 白日 烟霞 林谷 迥 ， 长风 鹤鹳 海天 浮 。 僧归 黄叶 峰前 寺 ， 水向 青龙 口中 流 。 只道 长安L 天 尺五 ， 谁云 此处 减 瀛州L 。
恭谒 长陵L	明	钱谦益	文皇P 神武 唐宗 后 ， 靖难 功成 战血 殷 。 铁骑 至今 趋 朔漠L ， 玉衣 终古 镇 燕山L 。 峰回 屏障 诸陵 拱 ， 日落 旌旗 万马 还 。 前后 北征 多 侍从 ， 承平 忝窃 史臣 间 。
卢沟L 晓月	明	李东阳	霜落 桑干L 水 未枯 ， 晓空 云尽 月轮 孤 。 一林 灯影 稀 还见 ， 十里 川光 澹 欲无 。 不断 邻鸡 催 短梦 ， 频来 征马 识 长途 。 石栏 桥上 时 翘首 ， 应傍 清虚 忆 帝都L 。
卢沟桥L	明	徐渭	沙浑 石涩 夹 山椒 ， 苦来 桑干L 月 一条 。 流出 卢沟L 成 大镜 ， 石桥 狮影 浸 拳毛 。
卢沟桥L	明	邹缉	河桥 残月 晓 苍苍 ， 远见 浑河L 一道 黄 。 树入 平郊 分 澹霭 ， 天空 断岸 隐 微光 。 北趋 禁阙L 神京L 近 ， 南去 征车 客路 长 。 多少 行人 此 来往 ， 马蹄 踏尽 五更 霜 。
卢沟L 曙色	明	王英	浑河L 东去 日 悠悠 ， 斜月 偏直 入 早秋 。 曙色 微涵 波影 动 ， 残光 犹带 浪花 流 。
过 卢沟桥L	明	于慎行	束发 承恩 禁苑L 游 ， 乡心 今夕 渡 卢沟L 。 千峰 过雨 官桥 暮 ， 廿载 飞尘 客 鬓秋 。 驿路 行分 三辅 界 ， 宫云 回见 五城 楼 。 车中 却听 浑河L 水 ， 阅尽 归骖 日夜 流 。
卢沟桥L	清	王鸣盛	卧虹 终古 枕 桑乾L ， 泱漭 浑河L 走 急湍 。 马邑 风烟 通 一线 ， 太行L 紫翠 压 千盘 。 唤人 喔喔 荒鸡 早 ， 照影 苍苍 晓色 寒 。 沙际 閒鸥 应 笑我 ， 又听 铃铎 送 征鞍 。
卢沟L	清	张问陶	卢沟L 南望 尽 尘埃 ， 木脱 霜寒 大漠 开 。 天海 诗情 驴背 得 ， 关山 秋色 雨中 来 。 茫茫 阅世 无 成局 ， 碌碌 因人 是 废才 。 往日 英雄 呼 不起 ， 放歌 空吊 古金台L 。
秋日 圆明园L 即景	清	爱新觉罗·弘历	红叶 千林 似 锦张 ， 秋容 端不 让 春光 。 南轩 日暖 帘 初捲 ， 曲沼 波寒 鱼 半藏 。 战雨 晚桐 漏 疏影 ， 冒霜 早菊 先 重阳 。 平添 诗客 三分 兴 ， 熟境 应忘 若个 忘 。
直沽L	元	王懋德	极目 沧溟 浸 碧天 ， 蓬莱L 楼阁 远 相连 。 东吴L 转海 输 粳稻 ， 一夕 潮来 集 万船 。
直沽L 棹歌	明	无名氏	云帆 十幅 下 津门L ， 日落 潮平 不见 痕 。 苇甸 茫茫 何处 泊 ， 一灯 明处 有 渔村 。
天津L	清	李源	津门L 连 渤海L ， 曲折 抱 长安L 。 食货 喧 商市 ， 鱼盐 乱 钓滩 。 鼍鸣 潮信 早 ， 龙过 雨声 寒 。 泼剌 银刀 重 ， 庖人 进 脍盘 。
登 蓟城L 西北楼 送 崔著作融P 入都	唐	陈子昂	蓟楼L 望 燕国L ， 负剑 喜 兹登 。 清规 子 方奏 ， 单戟 我 无能 。 仲冬 边风 急 ， 云汉 复 霜棱 。 慷慨 竟 何道 ， 西南 恨 失朋 。
渔阳L	唐	杜甫	渔阳L 突骑 犹 精锐 ， 赫赫 雍王P 都 节制 。 猛将 飘然 恐 后时 ， 本朝 不入 非 高计 。 禄山P 北筑 雄武城L ， 旧防 败走 归 其营 。 系书 请问 燕耆 旧 ， 今日 何须 十万 兵 。
后 出塞 五首	唐	杜甫	渔阳L 豪侠 地 ， 击鼓 吹 笙竽 。 云帆 转 辽海 ， 粳稻 来 东吴L 。
登 渔阳城L	清	黄辕	渔阳L 形胜 壮 边城 ， 雉堞 巍峨 拱 帝京L 。 日落 沽流 寒海 色 ， 风生 盘谷 乱涛 声 。 千秋 笳鼓 三军 暇 ， 百里 金汤 四塞 清 。 凭眺 酣歌 兴 不浅 ， 好磨 碑碣 记 升平 。
渔阳L 唐槐	清	李基和	记得 开元 寺里 松 ， 半随 浓艳 谢 春风 。 白头 谁复 谈 天宝 ， 风火 渔阳L 剩 此翁 。
于 北平L 作	唐	李世民	翠野 驻 戎轩 ， 卢龙L 转 征旆 。 遥山 丽 如绮 ， 长流 萦 似带 。 海气 百重 楼 ， 岩松 千丈 盖 。 兹焉 可 游赏 ， 何必 襄城L 外 。
盘山L 石刻 诗	明	无名氏	盘山L 高 巍峨 ， 半入 青云 里 。 中间 最上 峰 ， 更向 天边 起 。 行行 白 石崖 ， 六月 不 知暑 。
登 盘山L	明	王世贞	禅主 空祠 恒岳L 回 ， 谁怜 盘岭L 抱 燕台L 。 层峦 不尽 青天 去 ， 乱瀑 雄争 大壑 来 。 共指 丹梯 安 薜荔 ， 还挟 蜡屐 破 莓苔 。 银河 只在 微茫 里 ， 欲取 寒杓 作 酒杯 。
盘山L 道中	明	朱之蕃	盘山L 盘泉 盘崖壁 ， 百折 犹难 望 岭头 。 鸟乐 菁林 山果 熟 ， 客停 飞旆 野云 流 。 绿阴 遮屋 浑 忘暑 ， 白叟 歌田 不 解愁 。 极目 雄关 环 帝阙L ， 可知 奇奥 在 屏幽 。
清晨 入 盘山L 二首	清	爱新觉罗·玄烨	日出 入 盘山L ， 宸游 草木 闲 。 村庄 人 尽望 ， 处处 水 潺潺 。 当年 乘辇 到 ， 今日 复 来 游 。 山水 不同 色 ， 泉声 还 细流 。 
经 唐太宗P 晾甲石	清	爱新觉罗·弘历	石名 晾甲 枕 山陂 ， 遗迹 贞观 藉 抚追 。 若使 当年 无 此役 ， 何须 重建 魏徵P 碑 。
田盘L	清	宝廷	田盘L 如 瘦人 ， 骨节 皆 露外 。 山灵 戏 游人 ， 有意 弄 奇态 。 径无 十步 直 ， 石有 万种 怪 。 燕蓟L 多 名山 ， 屈指 此为 最 。
登 盘山L 绝顶	明	戚继光	霜角 一声 草木 哀 ， 云头 对起 石门 开 。 朔风 边酒 不成 醉 ， 落叶 归鸦 无数 来 。 但使 雕龙 销 杀气 ， 未妨 白发 老 边才 。 勒名 峰上 吾 谁与 ， 故 李将军P 舞 剑台 。
游 云罩寺L	清	李孔昭	绝顶 盘 空际 ， 登攀 近 日华 。 一峰 邻 造化 ， 四顾 俯 云霞 。 东海 神仙 宅 ， 西山L 帝子 家 。 连氛 遮 不见 ， 余兴 满 天涯 。
望 海潮·登 盘山L 绝顶	清	孙超	地雄 幽蓟L ， 襟连 恒岳L ， 一山 高矗 晴空 。 孤寺 罩云 ， 危峰 挂月 ， 何人 劈破 洪濛 。 呼吸 与天 通 。 看 下方 僧寺 ， 烟雾 朦胧 。 倚榭 掀髯 ， 一轮 红日 海门 东 。 登临 感喟 无穷 ， 算 沧桑 陵谷 ， 回首 匆匆 。 名士 谈禅 ， 将军 舞剑 ， 者回 唤醒 晨钟 。 星斗 快 罗胸 ， 喜 今朝 濯足 ， 踏碎 芙蓉 。 我欲 披衣 散发 ， 长啸 激 清风 。
舞剑台L 歌	清	洪昇	卫公P 东征 返 幽蓟L ， 头白 依然 气 精锐 。 酒酣 拔剑 舞 高台 ， 左盘 右旋 出 奇势 。 青萍 光射 战袍 赤 ， 白日 黄沙 暗 荒碛 。 掣电 流虹 若 有神 ， 百道 金蛇 散 碧空 。
宿 卫公庵L	清	阮晏锡	乍到 翻 疑梦 ， 如登 故国 山 。 路攀 千嶂 入 ， 人在 万松L 间 。 夜雨 泉边 至 ， 秋声 塞外 还 。 英雄 空 说剑 ， 何似 老僧 闲 。
独乐L 晨灯	明	胡富	高阁 层棱 数十 重 ， 晨灯 遥映 日光 红 。 依稀 萤火 笼 纱幕 ， 仿佛 残星 缀 月宫 。 珠箔 影摇 金 灿烂 ， 碧窗 光透 玉 玲珑 。 何如 化作 光明 烛 ， 遍照 贫家 万室 空 。
寄题 独乐寺L	清	爱新觉罗·弘历	欲留 羲御 问 迁移 ， 便是 拈花 不语 时 。 丈六 金身 应 好在 ， 春风 过客 偶 相思 。 禅心 远逐 穿 云磬 ， 古迹 空传 没 字碑 。 烟柳 丝丝 新绿 嫩 ， 即看 拖地 有 长眉 。
登 独乐寺L 佛阁	清	沈沐	秋高 阁敞 蔚蓝 天 ， 登眺 凭虚 各 凛然 。 对峙 遥空 联 白塔L ， 单留 古额 属 青莲P 。 疏林 晚听 千村 杵 ， 落日 晴炊 万灶 烟 。 独乐 何如 同 极乐 ， 欲将 此意 问 金仙 。
观 沧海L	汉	曹操	东临 碣石L ， 以观 沧海L 。 水何 澹澹 ， 山岛 竦峙 。 树木 丛生 ， 百草 丰茂 。 秋风 萧瑟 ， 洪波 涌起 。 日月 之行 ， 若出 其中 。 星汉 灿烂 ， 若出 其里 。 幸甚 至哉 ， 歌以 咏志 。
秦皇岛L	明	苗汝霖	登亭 试问 秦皇岛L ， 海上 神仙 信 有无 。 今古 几个 曾 羽化 ， 乾坤 何处 是 蓬壶L ？ 伐湘 不恤 千年 笑 ， 驱石 甘心 万骨 枯 。 丹药 未成 身 已死 ， 长城L 哪得 久 防胡 ！
渡海	清	沈受宏	一观 沧海L 失 江河 ， 捩柁 扬帆 发 浩歌 。 地到 尽时 天 不断 ， 人能 来处 鸟 难过 。 风如 黑雾 奔腾 急 ， 浪 比 银山 簸荡 多 。 却叹 田横P 心力 苦 ， 此中 曾复 弄 兵戈 。
海上	宋	戴敏	万面 鲸波 朝日 赤 ， 沧洲L 四望 无 穷极 。 海山 何处 是 蓬莱L ， 遍问 渔翁 都 不识 。
山海关L	明	黄洪宪	长城L 古堞 俯 沧瀛 ， 百二 河山 拥 上京L 。 银海 仙槎 来 汉使 ， 玉关L 秋草 戍 秦兵 。 星临 尾部 双龙 合 ， 月照 平沙 万马 明 。 闻道 辽阳L 飞羽 急 ， 书生 急欲 请 长缨 。
山海关L 城楼	明	戚继光	楼前 风物 隔 辽西L ， 日暮 凭栏 望 欲迷 。 禹贡 万年 归 紫极 ， 秦城 千里 静 雕题 。 蓬瀛L 只在 沧波 外 ， 宫殿 遥瞻 北斗 齐 。 为问 青牛 能 复度 ， 愿从 仙吏 授 刀圭 。
山海关L	清	汤右曾	东西 谁 界 绝 ， 封此 一 泥丸 。 地接 长城L 险 ， 天浮 渤海L 宽 。 连山 趋 碣石L ， 积水 见 辰韩L 。 吹角 关门 出 ， 边风 马首 寒 。
海上 杂诗	清	宋荦	杰阁 从前 代 ， 平看 碧海 流 。 千年 留 碣石L ， 一发 辨 登州L 。 潮送 斜阳 落 ， 风传 绝塞 秋 。 倚阑 聊 咏志 ， 俊鹘 下 荒洲 。
山海关L	清	爱新觉罗·玄烨	重关 称 第一 ， 扼险 倚 雄边 。 地势 长城L 接 ， 天空 沧海 连 。
风流子 · 出关 见 桃花	清	张惠言	海风 吹 瘦骨 ， 单衣 冷 、 四月 出 榆关L 。 看 地尽 塞垣L ， 惊沙 北走 ； 山侵 溟渤L ， 叠障 东还 。 人 何在 ？ 柳柔 摇 不定 ， 草短 绿 应难 。 一树 桃花 ， 向人 独笑 ； 颓垣 短短 ， 曲水 湾湾 。 东风 知 多少 ？ 帝城L 三月 暮 ， 芳思 都删 。 不为 寻春 较远 ， 辜负 春阑 。 念 玉容 寂寞 ， 更 无人 处 ， 经他 风雨 ， 能 几多 番 ？ 欲 附 西来 驿使 ， 寄与 春 看 。
山海关L	清	吴启元	地临 辽蓟 中分 界 ， 天限 华夷 第一 关 。 直绕 长城L 东 到海 ， 凌空 高障 北 依山 。 当年 士马 何曾 战 ， 此日 梯航 尚未 闲 。 闻道 乘槎 通 绝域 ， 可能 身入 斗牛 间 ？
捣练子	唐	无名氏	孟姜女P ， 杞梁P 妻 ， 一去 燕山L 更 不归 。 造得 寒衣 无人 送 。 不免 自家 送 征衣 。 长城L 路 ， 实 难行 ， 乳酪山 下 雪纷纷 。 吃酒 只为 隔饭病 。 愿 身 强健 早 还归 。
杞梁P 妻	唐	贯休	秦 之 无道 兮 四海 枯 ， 筑 长城L 兮 遮 北胡 。 筑人 筑土 一万 里 ， 杞梁P 贞妇 啼 呜呜 。 上 无父 兮 中 无夫 ， 下 无子 兮 孤 复孤 。 一号 城崩 塞色 苦 ， 再号 杞梁P 骨 出土 。 疲魂 饥魄 相逐 归 ， 陌上 少年 莫 相非 。
姜女祠L	清	爱新觉罗·玄烨	朝朝 海上 望夫 还 ， 留得 荒祠 半仞 山 ， 多少 征人 埋 白骨 ， 独将 大节 说 红颜 。
溥仁寺L 瞻礼	清	爱新觉罗·弘历	兴州L 最古 寺 ， 每到 礼 应亲 。 策马 河桥 度 ， 垂鞭 农务 询 。 即看 优泽 霈 ， 实胜 小霑 频 。 屏息 法云 地 ， 溥仁L 真 溥仁 。
普陀宗乘庙L 落成 拈香 得句	清	爱新觉罗·弘历	递肖 何妨 屡 普陀L ， 金刚 四句 括 无多 。 层楼 金瓦 辉香 象 ， 偏袒 黄衣 演 法螺 。 虔为 祝釐 开 八秩 ， 会逢 归极 仰 三摩 。 撰良 庆落 欣 瞻礼 ， 曰罪 曰知 且 付他 。
安远庙L	清	爱新觉罗·弘历	东岭 琳宫 接 ， 题门 各 有名 。 匪尊 不二法 ， 缘系 众藩 情 。 佛日 迎 薰朗 ， 慧云 收 雨征 。 金川L 兹武 定 ， 安远 永 销兵 。
锤峰L 落照	清	爱新觉罗·玄烨	纵目 湖山 千载 留 ， 白云 枕涧 报 清秋 。 巉岩 自有 争佳 处 ， 未若 此峰 景 最幽 。
棒槌峰L	清	赵翼	峰头 惊孑 立 ， 石笋 忽然 生 。 颇似 金茎 状 ， 殊惭 玉杵 名 。 空中 禅棒 喝 ， 月下 捣衣 声 。 远壮 行 都色 ， 孤标 接 太清 。
酹酒 孝贤皇后P 五律 之一	清	爱新觉罗·弘历	戊辰 今 癸未 ， 往事 梦 同伦 。 了识 生归灭 ， 宁知 媳娶孙 。 彤编 常 纪德 ， 永巷 尚 念恩 。 慽慽 诚 何益 ， 无须 结 习存 。
酹酒 孝贤皇后P 五律 之二	清	爱新觉罗·弘历	述怀 早 罢歌 ， 仪树 已 婆娑 。 复此 倾 杯酹 ， 那能 促 驾过 。 生前 恩 不尽 ， 别后 事 斯多 。 异室 斯 遥矣 ， 其遥 讵 几何 ？
蜀先主庙L	唐	刘禹锡	天地 英雄气 ， 千秋 尚 凛然 。 势分 三足 鼎 ， 业复 五铢钱 。 得相 能 开国 ， 生儿 不象 贤 。 凄凉 蜀 故妓 ， 来舞 魏宫 前 。
谒 昭烈庙L	宋	朱熹	谁怜 汉室 竟 三分 ， 桑柘 枯条 带 落曛 。 遗老 凋零 披 草莽 ， 故宫L 惨淡 会 风云 。 龙飞 旧国 传 今日 ， 龟载 穹碑 篆 古文 。 俯仰 空成 诗客 恨 ， 啼乌 满树 不堪 闻 。
涿州L 楼桑村L 先主庙L	元	傅若金	孤村 缥缈 见 灵祠 ， 废宅 苍茫 失 故基 。 蜀鬼 夜还 风 满盖 ， 涿人 朝祭 雨 沾旗 。 玺文 定复 归 寒水 ， 桑影 犹疑 履 短篱 。 终古 乡闾 有 遗恨 ， 衣冠 空想 汉 威仪 。
汉昭烈P	清	吴骐	金瓯 付托 耕莘 佐 ， 玉几 弥留 顾命 篇 ， 一代 英雄 生死 际 ， 铜台 遗令 最 堪怜 。
邯郸L 行	南北朝	陆厥	赵女 擪 鸣琴 ， 邯郸L 纷 躧步 。 长袖 曳 三街 ， 兼金 轻 一顾 。 有美 独 临风 ， 佳人 在 遐路 。 相思 欲 褰衽 ， 丛台L 日 已暮 。
邯郸L 行	元	傅若金	邯郸L 城头 下 白日 ， 邯郸L 市上 风 萧瑟 。 故垒 空余 鸟雀 悲 ， 荒垣 只见 狐狸 出 。 何王P 坟墓 对 山阿 ， 尚忆 诸侯 征战 多 。 赵客 归来 重 毛遂P ， 秦军 老去 畏 廉颇P 。 黄尘 白草 宫前 道 ， 鬼火 如灯 夜 相照 。 公子 秋来 不见 过 ， 美人 月下 那 闻笑 。 当时 冠盖 激 浮云 ， 挝钟 考鼓 宴 青春 。 只今 惟有 邮亭 树 ， 还送 年年 行路人 。
邯郸L 行	明	何景明	邯郸L 道上 车马 多 ， 行人 夜火 渡 漳河L 。 邯郸L 女儿 年 十五 ， 能弹 琵琶 善 歌舞 。 青灯 朱户 夜 当垆 ， 垆头 酒熟 唤客 沽 。 玉壶 有丝 为君 系 ， 不妨 醉向 邯郸L 途 。
赵王城L 怀古	清	王琴堂	古城 犹说 赵王都L ， 废址 颓垣 半有无 。 雉堞 逶逦 遍 禾黍 ， 龙台 荒秽 杂 樵苏 。 沧桑 世界 浮云 幻 ， 萧索 村墟 落日 孤 。 信是 人才 随 气运 ， 空怀 廉蔺P 读 踟蹰 。
听话 丛台L	唐	李远	有客 新从 赵地 回 ， 自言 曾上 古 丛台L 。 云遮 襄国L 天边 去 ， 树绕 漳河L 地里 来 。 弦管 变成 山鸟 弄 ， 绮罗 留作 野花 开 。 金舆 玉辇 无 行迹 ， 风雨 惟知 长 绿苔 。
丛台L	明	白金南	天桥 雪洞 倚 云霄 ， 妆阁 名花 照 罗绮 ， 台上 弦歌 醉 美人 ， 台下 橐鞬 耀 武士 。
邯郸L	清	宋琬	赵王宫L 北 古 丛台L ， 歌舞 当年 翠辇 来 。 白马 大梁公子P 过 ， 黄金 东海 鲁连P 回 。 三千 珠履 人 何往 ， 十五 银筝 歌 自哀 。 寂寞 平原 抔土 在 ， 麒麟 荒缺 卧 苍苔 。
登 丛台L	清	爱新觉罗·弘历	传闻 好事 说 丛台L ， 胜日 登临 霁景 开 。 丰岁 人民 多 喜色 ， 高楼 赋咏 谢 雄才 。 襟漳 带沁 真佳 矣 ， 雪洞 天桥 安在 哉 。 烟树 迷茫 闾井 富 ， 为筹 元气 善 滋培 。
赵丛台L	现代	郭沫若	邯郸L 市内 赵丛台L ， 秋日 登临 曙色 开 。 照黛 妆楼 遗 废迹 ， 射骑 胡服 思 雄才 。
古风五十九首	唐	李白	燕昭P 延 郭隗P 。 遂筑 黄金台L 。 剧辛P 方 赵至 。 邹衍P 复 齐来 。
登 幽州台L 歌	唐	陈子昂	前 不见 古人 ， 后 不见 来者 。 念 天地 之 悠悠 ， 独 怆然 而 涕下 ！
于 易水L 送人	唐	骆宾王	此地 别 燕丹P ， 壮士 发 冲冠 。 昔时 人 已没 ， 今日 水 犹寒 。
渡 易水L	明	陈子龙	并刀 昨夜 匣中 鸣 ， 燕赵 悲歌 最 不平 。 易水L 潺湲 云草 碧 ， 可怜 无处 送 荆卿P ！
咏 荆轲P	魏晋	陶渊明	燕丹P 善 养士 ， 志在 报 强嬴 。 饮饯 易水L 上 ， 四座 列 群英 。 素骥 鸣 广陌 ， 慷慨 送我 行 。 雄发 指 危冠 ， 猛气 冲 长缨 。 渐离P 击 悲筑 ， 宋意P 唱 高声 。 心知 去 不归 ， 且有 后世 名 。 其人 虽 已没 ， 千载 有 馀情 。
易水L 歌	战国	荆轲	风 萧萧 兮 易水L 寒 ， 壮士 一去 不 复还 ！
易水L 行	明	何景明	寒风 夕吹 易水L 波 ， 渐离P 击筑P 荆卿P 歌 。 白衣 洒泪 当 祖路 ， 日落 登车 去 不顾 。 秦王殿 上 开 地图 ， 舞阳P 色沮 那敢 呼 。 手持 匕首 摘 铜柱 ， 事已 不成 空 骂倨 。
登 古 邺城L	唐	岑参	下马 登 邺城L ， 城空 复 何见 。 东风 吹 野火 ， 暮入 飞云殿 。 城隅 南对 望陵台L ， 漳水L 东流 不 复回 。 武帝P 宫中 人 去尽 ， 年年 春色 为谁 来 。
过 邺中L	宋	刘子翚	逐鹿 营营 一梦 惊 ， 事随 流水 去 无声 。 黄沙 日傍 荒台 落 ， 绿树 入穿 废苑 行 。 遗恨 分香 怜 晚节 ， 胜游 飞盖 想 高情 。 我来 不暇 论 兴废 ， 一点 西山L 入 眼明 。
邺城L 道	明	袁宏道	何处 魏 离宫 ， 荒烟 断 苇中 。 猎蹄 晴 卷雪 ， 高隼 怒 盘风 。 苑古 梧桐 秃 ， 墙崩 枸杞 红 。 空台 与 流水 ， 想象 旧 帘栊 。
邺都L 怀古	清	尤珍	风流 佳丽 魏王都 ， 忆昔 雄豪 创 霸图 。 邺苑 人空 花 自落 ， 铜台L 伎散 鸟 争呼 。 五官 事业 埋 荒陇 ， 七子 才名 付 酒垆 。 惟有 漳河L 东 逝水 ， 年年 春涨 浴 飞凫 。
邺中L	明	陈恭尹	山河 百战 鼎 终分 ， 叹息 漳南L 日暮 云 。 乱世 奸雄 空 复尔 ， 一家 词赋 最 怜君 。 铜台L 未散 吹 笙伎 ， 石马 先传 出 水文 。 七十二 坟 秋草 遍 ， 更 无人 表 汉将军 。
铜爵L 妓	南北朝	江淹	武皇P 去 金阁 ， 英威 长 寂寞 。 雄剑 顿 无光 ， 杂佩 亦 销烁 。 徒登 歌舞台 ， 终成 蝼蚁郭 ！
赤壁L	唐	杜牧	折戟 沉沙 铁 未销 ， 自将 磨洗 认 前朝 。 东风 不与 周郎P 便 ， 铜雀L 春深 锁 二乔P 。
铜雀台L	唐	梁琼	歌扇 向陵 开 ， 齐行 奠 玉杯 。 舞时 飞燕 列 ， 梦里 片云 来 。 月色 空 馀恨 ， 松声 莫 更哀 。 谁怜 未死 妾 ， 掩袂 下 铜台L 。
铜雀台L	唐	张琰	君王 冥漠 不 可见 ， 铜雀L 歌舞 空 徘徊 。 西陵L 啧啧 悲 宿鸟 ， 高殿 沈沈 闭 青苔 。
铜雀台L 怨	唐	程长文	豪华 去后 行人 绝 ， 箫筝 不响 歌喉 咽 。 雄剑 无威 光彩 沈 ， 宝琴 零落 金星 灭 。 玉阶 寂寞 坠 秋露 ， 月照 当时 歌舞 处 。 当时 歌舞 人 不回 ， 化为 今日 西陵L 灰 。
邺城L	唐	罗隐	台上 年年 掩 翠蛾 ， 台前 高树 夹 漳河L 。 英雄 亦到 分香 处 ， 能 共 常人 较 几多 。
登 正定 天宁阁L	明	李攀龙	高阁 崚嶒 倚 素秋 ， 西山L 寒影 挂 城头 。 坐来 大陆L 当 窗尽 ， 不断 滹沱L 入 槛流 。 下界 苍茫 元气 合 ， 诸天 缥缈 白云 愁 。 使君 趋省 无 多眺 ， 暂而 登临 此 壮游 。
邯郸L 道	宋	范成大	薄晚 霜侵 使者 车 ， 邯郸L 阪峻 且 徐驱 。 困来 也作 黄粱梦 ， 不梦 封侯 梦 石湖L 。
邯郸L 道上	清	宋荦	邯郸L 道上 起 秋声 ， 古木 荒祠 野潦 清 。 多少 往来 名利 客 ， 满身 尘土 拜 卢生P 。
题 卢生P 卧像	清	陈潢	富贵 荣华 五十 秋 ， 纵然 一梦 也 风流 。 而今 落拓 邯郸L 道 ， 愿与 先生 借 枕头 。
太原L 早秋	唐	李白	岁落 众芳 歇 ， 时当 大火 流 。 霜威 出塞 早 ， 云色 渡 河秋 。 梦绕 边城 月 ， 心飞 故国 楼 。 思归 若 汾水L ， 无日 不 悠悠 。
并州L 路	唐	李宣远	秋日 并州L 路 ， 黄榆 落 故关 。 孤城 吹角 罢 ， 数骑 射雕 还 。 帐幕 遥 临水 ， 牛羊 自 下山 。 征人 正 垂泪 ， 烽火 起 云间 。
游 烈石L	唐	李频	游访 曾经 驻马 看 ， 窦犫P 遗像 在 林峦 。 泉分 石洞 千条 碧 ， 人在 冰壶 六月 寒 。 时雨 欲来 腾 雾霭 ， 微风 初动 漾 波澜 。 个中 若置 羊裘叟P ， 绝胜 当年 七里滩L 。
忆 旧游 寄 谯郡L 元参军P	唐	李白	时时 出向 城西 曲 ， 晋祠L 流水 如 碧玉 。 浮舟 弄水 箫鼓 鸣 ， 微波 龙鳞 莎草 绿 。
晋溪	金	小仓月	削桐宫殿L 古溪泉L ， 寰海 声高 利济 全 。 晓月 僧钟 云外 寺 ， 晚山 渔笛 浪头 船 。 三秋 白雁 芦花 雪 ， 二月 金莺 杨柳 烟 。 野老 石桥 驴背 上 ， 人家 村落 锦屏 前 。
浣溪沙 · 晋祠L	元	姜彧	山滴 岚光 水 拍堤 ， 草香 沙暖 净 无泥 。 只疑 误入 武陵溪L 。 两岸 桃花 烘 日出 ， 四围 高柳 到 天垂 。 一尊 心事 百年 期 。
忆 晋祠L 风景 且 以致 望雨 之意	明	于谦	悬瓮 山前 境趣 幽 ， 邑人 云 是 小 瀛州L 。 群峰 环耸 青螺髻 ， 合涧 中分 碧玉 流 。 出洞 神龙 和雾 起 ， 凌波 仙女 弄珠 游 。 愿将 一掬 灵祠 水 ， 散作 甘霖 遍 九州 。
游 晋祠L	清	金农	叔虞祠L 不改 ， 水木 发 清妍 。 蔼蔼 长生树 ， 泠泠 难老泉L 。 影为 青伞 云 ， 味在 玉浆 前 。 更领 凉堂 趣 ， 风中 挥 七弦 。
难老泉L	清	戴王命	悬瓮山L 前 别有天 ， 滔滔 活水 几经年 ？ 古今 多少 兴亡事 ， 天地 同流 难老泉L 。
登 北岳L	清	毛如瑜	恒岳L 嶙峋 四望 开 ， 正逢 春色 气佳 哉 。 风烟 下瞰 中原 尽 ， 形势 遥从 万里 来 。 手接 星辰 依座 近 ， 身径 虎豹 扣关 回 。 吾庐 东岱L 登临 旧 ， 争长 崔巍 未易 裁 。
北岳庙L	唐	贾岛	天地 有 五岳L ， 恒岳L 居 其北 。 岩峦 叠 万重 ， 诡怪 浩 难测 。 人来 不敢 入 ， 祠宇 白日 黑 。 有时 起 霖雨 ， 一洒 天地 德 。 神兮 安在 哉 ， 永康 我 王国 。
登 恒山L	明	汪承爵	云中L 天下 脊 ， 尤见 此 山尊 。 八水 皆 南汇 ， 群峰 尽 北蹲 。 仙台 临日 迥 ， 风窟 护 云屯 。 剩有 搜 奇兴 ， 空怜 前路 昏 。
琴棋台L	明	董释	恒山L 绝顶 即 蓬莱L ， 传说 神仙 到 此台 。 当日 琴囊 随 野鹤 ， 至今 棋局 锁 苍苔 。 砌旁 瑶草 年年 长 ， 洞口 桃花 岁岁 开 。 直上 云梯 凭 一览 ， 恍然 身向 广寒 来 。
云州L 秋望	清	屈大均	白草 黄羊 外 ， 空闻 觱篥 哀 。 遥寻 苏武庙L ， 不上 李陵台L 。 风助 群鹰 击 ， 云随 万马 来 。 关前 无数 柳 ， 一夜 落 龙堆L 。
题 石窟	唐	宋昱	梵宇 开 金地 ， 香龛 凿 铁围 。 影中 群象 动 ， 空里 众灵 飞 。 邀福 功 虽在 ， 兴王 代久 非 。 谁知 云朔L 外 ， 更睹 化胡 归 。
云冈佛祠L	清	王度	耸峰 危阁 与 天齐 ， 俯瞰 尘寰 处处 低 。 亿万 化身 开 绝嶂 ， 三千 法界 作 丹梯 。 乾坤 再辟 雷 初奋 ， 海岳 重光 月 指迷 。 我欲 凌虚 朝 王陛 ， 好从 灵鹫L 问 金泥 。
五台山L	元	顾瑛	海涌 如来 室 ， 清凉L 即 五台L 。 春风 山顶 雪 ， 飞度 雁门L 来 。
台山L 杂咏	金	元好问	西北 天低 五顶 高 ， 茫茫 松海 露 灵鳌 。 太行L 直上 犹 千里 ， 井底 残山 枉 呼号 。 万壑 千岩 位置 雄 ， 偶从 天巧 见 神功 。 湍溪 已作 风雷 恶 ， 更在 云山 气象 中 。
东台L	北宋	张商英	迢迢 云水 陟 峰峦 ， 渐觉 天低 宇宙 宽 。 东北 分明 观 大海 ， 西南 咫尺 望 长安L 。 圆光 化现 珠 千颗 ， 旭日 初升 火 一团 。 风雨 每从 岩下起 ， 那罗洞 里 有 龙蟠 。
咏 五台山L 南台L	明	史监	翠拔 南天 第二台 ， 天成 图画 一方 开 。 巅岩 有路 皆 悬石 ， 古树 无枝 半是 苔 。 潭龙 起处 电光 走 ， 木客 啸时 山雨 来 。 俯仰 独怀 千古 意 ， 诗成 倚杖 漫 徘徊 。
中台L 拥 翠峰	明	史鉴	上方 楼阁 耸 奇观 ， 金磐 泠泠 度 翠峦 。 深树 浮岚 晴 带雨 ， 阴崖 积雪 夏 生寒 。 鳌行 樊愿 星辰 近 ， 云气 氤氲 宇宙 宽 。 何处 紫箫 吹 落月 ， 不胜 清思 绕 名端 。
登 黛螺顶L	清	爱新觉罗·弘历	峦回 谷抱 自 重重 ， 螺顶 左邻 据 别峰 。 云栈 屈盘 历 霄汉 ， 花宫 独涌 现 芙蓉 。 窗前 东海 初升 日 ， 阶下 千年 不老松 。 供养 五台L 曼殊 象 ， 阇黎 疑 未 识 真宗 。
题 应县L 木塔	明	乔宇	矗矗 栏杆 面面 迎 ， 盘空 万木 费 支撑 。 山川 一览 云中L 胜 ， 烽火 遥连 塞上 兵 。 岁纪 辽金 留 往迹 ， 郡 经 秦汉 有 威名 。 云梯 踏遍 穹窿 顶 ， 蜂蚁 纷纷 下界 行 。
雁门L 胡人 歌	唐	崔颢	高山 代郡L 东接 燕 ， 雁门L 胡人 家 近边 。 解放 胡鹰 逐 塞鸟 ， 能将 代马 猎 秋田 。 山头 野火 寒 多烧 ， 雨里 孤峰 湿 作烟 。 闻道 辽西L 无 斗战 ， 时时 醉向 酒家 眠 。
过 雁门L 见雁	北宋	黄庭坚	家在 孤云 落照 间 ， 行人 已上 雁门关L 。 凭君 为报 平安信 ， 才是 云中L 第一山 。
发 南楼 度 雁门关L	金	元好问	棱磳 石磴 倚 高梯 ， 穹谷 无人 绿树 齐 。 总为 古来 征戍 苦 ， 宿云 常傍 塞垣L 低 。
关外 吟 古诗	金	无名氏	雁门关L 外 野 人家 ， 不种 桑榆 不种 麻 。 百里 并无 梨枣树 ， 三春 那得 杏桃花 。 六月 雨遇 山头 雪 ， 狂风 遍地 起 黄沙 。 说于 江南L 人 不信 ， 早穿 皮袄 午穿 纱 。
雁门关L 外	元	元好问	四海 于今 正 一家 ， 生民 何处 不 桑麻 。 重关 独居 千寻岭 ， 深夏 犹飞 六出花 。 云暗 白杨 连 马邑L ， 天围 青冢L 渺 龙沙L 。 凭高 吊古 情 无尽 ， 空对 西风 数 去鸦 。
晚度 雁门L	明	杨基	关山 迢递 朔云 高 ， 风紧 霜花 织 毳袍 。 此地 宣威 称 李牧P ， 有谁 再退 北 羌豪 。
过 雁门L	明	李贽	尽道 当关 用 一夫 ， 昔人 曾此 扦 匈奴 。 如今 冒顿 来 稽颡 ， 李牧P 如前 不足 都 。
雁门L 耸秀	明	武文	少昊 行秋 紫塞L 凉 ， 雨馀 顿改 雁山L 先 。 虎帜 旌旗 浓墨 染 ， 石壁 楼台 淡粉 装 。 红叶 饱霜 浑 觉醉 ， 黄花 笑日 欲 飘香 。 此时 边将 凭栏 目 ， 五色云 飞 绕 帝乡 。
雁门关L	清	朱彝尊	白登L 雁门L 道 ， 骋望 勾注L 巅 。 山冈 郁 参错 ， 石栈 纷 钩连 。 度岭 风 渐生 ， 入关 寒 凛然 。 抗迹 怀 古人 ， 千载 多 豪贤 。 时来 英雄 奋 ， 事去 陵谷 迁 。 古人 不可期 ， 劳歌 为谁 宣 ？ 嗷嗷 中泽 鸿 ， 聆 我 慷慨 言 。
娘子关L 偶成	明	王世贞	夫人城L 北 走降氐 ， 娘子军 前 高义旗 。 今日 关头 成 独笑 ， 可无 巾帼 赠 男儿 。
娘子关L	清	王祖庚	娘子 军容 讲 武台 ， 雄关 嵲屼 倚 山偎 。 城临 苇泽 湍流 急 ， 寨望 承天 曙色 开 。 寻到 源头 飞瀑 雨 ， 坐来 树底 绝 氛埃 。 圣朝 休养 干戈 息 ， 郑国渠L 边 沃草 莱 。
同 崔邠P 登 鹳雀楼L	唐	李益	鹳雀楼L 西 百尺 樯 ， 汀洲 云树 共 茫茫 ， 汉家 箫鼓 空 流水 ， 魏国 山河 半 夕阳 。 事去 千年 犹 恨速 ， 愁来 一日 即 为长 。 风烟 并起 思 归望 ， 远目 非春 亦 自伤 。
同 赵校书P 题 普救寺L	唐	杨巨源	东方 高处 天 ， 一望 几 悠然 。 白浪 过 城下 ， 青山 满 寺前 。 尘光 分 驿道 ， 岚色 到 人烟 。 气象 须 文字 ， 逢君 大雅 篇 。
谒 解州L 关帝庙	明	曹忭	条山 崒嵂 钟灵 地 ， 江水 逶迤 宗 汉心 。 千古 荆门L 魂 不散 ， 三分 炎鼎 气 先沉 。 英风 宇宙 人 同仰 ， 血食 乡邦 世 所钦 。 信有 神威 震 华夏 ， 愿凭 馀勇 扫 氛祲 。
中条山L	唐	韩愈	条山L 苍 ， 河水 黄 。 浪波 沄沄 去 ， 松柏 在 山冈 。
蒲州L 道中	唐	畅当	苍苍 中条山L ， 厥 形 极 奇磈 。 我欲 涉 其 崖 ， 濯足 黄河L 水 。
蒲关L 西道 中 作	唐	李山甫	国东 王气 凝 蒲关L ， 楼台 帖出 晴 空间 。 紫烟 横捧 大舜庙L ， 黄河L 直打 中条山L 。 地锁 咽喉 千古 壮 ， 风传 歌吹 万家 闲 。 来来 去去 身 依旧 ， 未及 潘年 鬓 已斑 。
游 栖岩寺L	唐	李益	晚上 昙延洞L ， 通宵 兴 莫穷 。 高明 千嶂 月 ， 清爽 一岩 风 。 坐久 衣衫 润 ， 吟余 物象 空 。 举头 星 可摘 ， 疑在 广寒宫 。
栖岩寺L	金	张瓒	林表 照人 白塔L 明 ， 竹间 兰芷 石泉 清 。 惠崇P 水木 西轩 景 ， 烟 带 平芜 水 带 城 。
禹门L 叠浪	明	孟养浩	登眺 龙门L 眼界 宽 ， 层层 雪浪 逐 飞湍 ， 分明 圣迹 昭 千古 ， 莫作 寻常 景物 看 。
禹门L	明	薛瑄	连山 忽断 禹门L 开 ， 中有 黄河L 滚滚 来 。 更欲 登临 穷 胜景 ， 却愁 咫尺 会 风雷 。
禹门L	明	薛瑄	不放 黄河L 走 ， 层层 锁 石门 。 驾空 腾 雪浪 ， 夺隘 战 乾坤 。 南北 中条L 划 ， 地天 人力 尊 。 如何 开辟 久 ， 元气 尚 浑浑 。
龙门L	清	吴镇	粒食 安居 者 ， 相忘 大禹P 功 。 此间 无 斧凿 ， 天下 尽 蛇龙 。
九日 游 龙门L	清	康乃心	大野 苍山 断 ， 洪波 两岸 开 。 石岩 惊 立壁 ， 河势 似 雷奔 。 俗自 唐虞P 古 ， 功从 忠孝 来 。 居人 传 禹墓L ， 是否 漫 相猜 。
龙门L	清	刘仑	曾经 积石L 睹 神功 ， 谁信 龙门L 势 更雄 。 水绕 华夷 千地 转 ， 山横 秦晋 一流 通 。 惊涛 乱卷 暗 天雪 ， 断壁 长披 尽 日风 。 劈凿 遗痕 今 尚在 ， 万年 明德 祀 无穷 。
留题 藏山L	明	傅山	藏山L 藏在 九原L 东 ， 神路 双松 谡谡 风 。 雾嶂 几层 宫霍鲜 ， 霜苔 三色 绿黄红 。 当年 难易 人 徒说 ， 满壁 丹青 画 不空 。 忠在 晋家 山 亦敬 ， 南峰 一笏 画 楼中 。
题 风陵渡L	金	赵子贞	一水 分 南北 ， 中源 气 自全 。 云山 连 晋壤L ， 烟树 入 秦川L 。 落日 黄尘 起 ， 晴沙 白鸟 眠 。 挽输 今 正急 ， 忙杀 渡头船 。
登 单于台L	唐	张蠙	边兵 春尽 回 ， 独上 单于台L 。 白日 地中 出 ， 黄河L 天外 来 。 沙翻 痕 似浪 ， 风急 响 疑雷 。 欲向 阴关L 度 ， 阴关L 晓 不开 。
征怨	唐	柳中庸	岁岁 金河L 复 玉关L ， 朝朝 马策 与 刀环 。 三春 白雪 归 青冢L ， 万里 黄河L 绕 黑山L 。
归化城L 杂咏	清	徐兰	祁连L 呼吸 与天 通 ， 不与 人间 节候 同 。 后骑 解衣 风柳 下 ， 前军 堕指 雪花 中 。 发离 汉地 根 先白 ， 泪过 秦山L 色 变红 。 驺伍 漫劳 歌 况瘁 ， 侯王 犹自 佩 雕弓 。
归化城L	清	王循	西北 风雪 连 九徼L ， 古今 形势 重 三边L 。 穹庐 已绝 单于域L ， 牧地 犹称 土默川L 。 小部 梨园 同 上国 ， 千家 闹京 入 丰年 。 圣朝 治化 无 中外 ， 十万 貔貔 尚 控弦 。
王昭君P	唐	李白	汉家 秦地 月 ， 流影 照 明妃P 。 一上 玉关L 道 ， 天涯 去 不归 。 汉月 还从 东海 出 ， 明妃P 西嫁 无 来日 。 燕支L 长寒 雪 作花 ， 蛾眉 憔悴 没 胡沙 。 生乏 黄金 枉 图画 ， 死留 青冢L 使人 嗟 。
咏怀 古迹 五首	唐	杜甫	一去 紫台 连 朔漠L ， 独留 青冢L 向 黄昏 。 画图 省识 春风 面 ， 环佩 空归 夜月 魂 。
青冢L	金	王元节	环佩 魂归 青冢L 月 ， 琵琶 声断 黑山L 秋 。 汉家 多少 征西将 ， 泉下 相逢 也 合羞 。
过 青冢L 用 先君文献公P 韵	元	耶律楚材	汉室 空成 一 土丘 ， 至今 仍未 雪 前羞 。 不禁 出塞 涉 沙碛 ， 最恨 临轩 辞 冕旒 。 幽怨 半和 青冢L 月 ， 闲云 常锁 黑河L 秋 。 滔滔 天堑 东流 水 ， 不尽 明妃P 万古 愁 。
青冢L	清	王循	怨魄 传 青冢L ， 灵风 此 黑河L 。 黄沙 迷 古渡L ， 翠霭 护 烟螺 。 女子 英雄 泪 ， 琵琶 壮士 歌 。 一心 争 不朽 ， 莫谩 蹙 双蛾 。
昭君P 青冢L	清	张鹏翮	独留 青冢L 古城隅 ， 愧杀 当年 汉大夫 。 万里 长城L 凭 粉黛 ， 千秋 国士 老 樵渔 。 香溪L 流影 魂 飞动 ， 塞上 吹箫 凤 有无 ？ 延寿 写真 君 莫恨 ， 长门 空锁 月明 孤 。
题 明妃P 出塞 图	清	黄幼藻	天外 边风 扑面 沙 ， 举头 何处 是 中华 。 早知 身破 丹青 误 ， 但嫁 巫山L 百姓家 。
王昭君P	清	陈葆贞	紫塞L 长门 一样 悲 ， 何须 终老 向 宫帷 。 不如 绝塞 和亲 去 ， 还得 君王 斩 画师 。
夜 浦 涛声	宋	无名氏	春申浦L 水 碧 如秋 ， 万顷 淙淙 夜 更幽 。 日落 江空 人 唤渡 ， 月明 潮上 客 登楼 。
黄浦L	元	顾从礼	黄浦L 滩头 微雨 晴 ， 龙华L 渡口 晚潮 生 。 行人 夜泊 应 无语 ， 试听 吴歌 欸乃 声 。
浦江L 竹枝词	明	秦荣光	十八 潮头 最 壮观 ， 观潮 第一 浦江L 滩 。 银涛 万叠 如 山涌 ， 两岸 花飞 卷 雪端 。 鼓角声 中 焕彩 游 ， 浦江L 午日 闹 龙舟 。 红儿 绿女 沿滩 看 ， 看客 多登 丹凤楼L 。
夜眺 浦江L	明	曹泰	月照 黄龙L 浦水 黄 ， 南飞 鸟鹊 夜 茫茫 。 晚潮 天接 海门 远 ， 秋草 城埋 沪渎 荒 。 洲上 人家 金井 榻 ， 县中 官酒 玉缸 香 。 百年 来往 今 头白 ， 消得 浮生 梦 几场 。
浦滩L 夜月	清	袁祖志	万里 长空 镜 若磨 ， 楼台 倒影 入 江波 。 此邦 亦有 清凉 境 ， 端赖 长吟 共 短歌 。
龙华L 夜泊	唐	皮日休	今市 犹存 古刹 名 ， 草桥 霜滑 有人 行 。 尚嫌 残月 清光 少 ， 不见 波心 塔影 横 。
登塔 眺望	南宋	陆游	乘月 上 浮屠L ， 还见 群峰 影 。 金焦L 是耶非 ， 一点 渔灯 冷 。
龙华L 古塔	明	冯迁	千年 飞塔 标 沧海 ， 蹑尽 高层 霁色 开 。 翠盖 重重 吴树 起 ， 青螺 点点 越山 来 。
漪园L 坐雨	清	陈以谦	水边 亭子 竹边 楼 ， 烟雨 凄迷 晚 不收 。 绝似 家乡 旧 风景 ， 芦花 枫叶 泖湖L 秋 。
淀山湖L	元	杨维桢	半空 楼阁 淀山寺L ， 三面 篷樯 湖口 船 。 芦叶 响时 风 似雨 ， 浪花 平处 水 如天 。 沽来 村酒 浑 无味 ， 买得 鲈鱼 不 论钱 。 明日 垂虹 桥下 过 ， 与君 停棹 吊 三贤 。
泛 淀山湖L	明	徐祯稷	雪浪 堆 三泖L ， 风帆 挂 淀湖L 。 断云 收雨 净 ， 高树 入秋 孤 。 暮色 诸峰 碧 ， 寒声 一雁 呼 。 沧浪 歌罢 去 ， 渔父 定 吾徒 。
游 龙华寺L	明	顾英	十里 城西 小路 斜 ， 寻幽 闲到 梵王家L 。 三生 说梦 逃 名教 ， 八景 题诗 纪 岁华 。 野鹤 踏翻 松顶 雪 ， 山禽 啼落 树头 花 。 登临 不尽 春游 兴 ， 笑语 山童 再 煮茶 。
松江L 竹枝词	清	黄霆	巍巍 楼阙 梵王宫L ， 金碧 名蓝 杳霭 中 。 近海 浮屠L 三十六 ， 怎如 方塔L 最 玲珑 。
入朝曲	南北朝	谢朓	江南L 佳丽 地 ， 金陵L 帝王 州 。 逶迤 带 绿水 ， 迢递 起 朱楼 。 飞甍 夹 驰道 ， 垂杨 荫 御沟 。 凝笳 翼 高盖 ， 叠鼓 送 华辀 。 献纳 云台L 表 ， 功名 良 可收 。
晚登 三山 还望 京邑L	南北朝	谢朓	灞涘 望 长安L ， 河阳L 视 京县L 。 白日 丽 飞甍 ， 参差 皆 可见 。 余霞 散成 绮 ， 澄江 静如 练 。 喧鸟 覆 春洲 ， 杂英 满 芳甸 。 去矣 方 滞淫 ， 怀哉 罢 欢宴 。 佳期 怅 何许 ， 泪下 如 流霰 。 有情 知 望乡 ， 谁能 鬒 不变 ？
金陵L 歌 送别 范宣P	唐	李白	石头L 巉岩 如 虎踞 ， 凌波 欲过 沧江 去 。 钟山L 龙盘 走势 来 ， 秀色 横分 历阳 树 。 四十余 帝 三百 秋 ， 功名 事迹 随东 流 。 金陵L 昔时 何壮 哉 ， 席卷 英豪 天下 来 。 冠盖 散为 烟雾 尽 ， 金舆 玉座 成 寒灰 。 天子 龙沉 景阳井 ， 谁歌 玉树 后庭花 。
金陵L 三首	唐	李白	晋家 南渡 日 ， 此地 旧 长安L 。 地即 帝王 宅 ， 山为 龙虎 盘 。 金陵L 空 壮观 ， 天堑 净 波澜 。 醉客 回桡 去 ， 吴歌 且 自欢 。 地拥 金陵L 势 ， 城回 江水 流 。 当时 百万 户 ， 夹道 起 朱楼 。 亡国 生 春草 ， 离宫 没 古丘 。 空余 后湖L 月 ， 波上 对 瀛州L 。
赠 升州L 王使君忠臣P	唐	李白	六代 帝王 国 ， 三吴L 佳丽 城 。 贤人 当 重寄 ， 天子 借 高名 。 巨海 一边 静 ， 长江L 万里 清 。 应须 救 赵策 ， 未肯 弃 侯嬴P 。
登 金陵L 凤凰台L	唐	李白	凤凰台L 上 凤凰 游 ， 凤去 台空 江 自流 。 吴宫 花草 埋 幽径 ， 晋代 衣冠 成 古丘 。 三山 半落 青天 外 ， 二水 中分 白鹭洲L 。 总为 浮云 能 蔽日 ， 长安L 不见 使人 愁 。
月夜 金陵L 怀古	唐	李白	苍苍 金陵L 月 ， 空悬 帝王 州 。 天文 列宿 在 ， 霸业 大江 流 。 绿水 绝 驰道 ， 青松 摧 古丘 。 台倾 鳷鹊观L ， 宫没 凤凰楼L 。 别殿 悲 清暑 ， 芳园 罢 乐游 。 一闻 歌 玉树 ， 萧瑟 后庭 秋 。
金陵L 五题	唐	刘禹锡	朱雀桥L 边 野草花 ， 乌衣巷L 口 夕阳 斜 。 旧时 王谢 堂前 燕 ， 飞入 寻常 百姓 家 。
金陵L 怀古	唐	许浑	玉树 歌残 王气 终 ， 景阳L 兵合 戍楼 空 。 松楸 远近 千官 冢 ， 禾黍 高低 六代 宫 。 石燕 拂云 晴 亦雨 ， 江豚 吹浪 夜 还风 。 英雄 一去 豪华 尽 ， 惟有 青山 似 洛中L 。
题 金陵L	元	陆仁	丽正门 当 天阙 高 ， 景阳台L 下 草 萧萧 。 江围 大地 蟠 三楚 ， 石偃 孤城 见 六朝 。 落日 不将 遗恨 去 ， 秋风 能使 旅魂 消 。 忘情 只有 龙河L 柳 ， 烟雨 年年 换 旧条 。
登 金陵L 雨花台L 望 大江L	明	高启	江山 相雄 不 相让 ， 形胜 争夸 天下 壮 。 秦皇P 空此 瘗 黄金 ， 佳气 葱葱 至今王 。 前 三国 ， 后 六朝 ， 草生 宫阙 何 萧萧 。 英雄 乘时 务 割据 ， 几度 战血 流 寒潮 。
金陵L 雨后 登楼	明	彭泽	醉依 危栏 看 雨收 ， 分明 远树 见 晴洲 。 千年 壮丽 山 为郭 ， 十里 人家 水 绕楼 。 燕子 近来 谁是主 ， 凤凰 已去 有 遗秋 ， 如何 东晋 诸 名士 ， 却上 新亭L 双泪 流 。
金陵L 怀古	清	倪瑞璿	石头L 天险 壮 层城 ， 虎踞 龙蟠 旧 有名 。 峙鼎 三分 吴大帝P ， 渡江 五马 晋东京P 。 高台 凤去 荒烟 满 ， 废苑 萤飞 茂草 生 。 往事 不堪 频 想象 ， 夕阳 西下 看 潮平 。
金陵L 怀古	清	陈恭尹	山 飞 楼阁 水 飞 霞 ， 冷落 春城 宿 乳鸦 。 天阙L 双峰 铦 似戟 ， 海门 高浪 白 如花 。 空劳 玉辇 销 王气 ， 曾划 长江L 作 帝家 。 五马 渡江 龙化 后 ， 南方 文物 掩 中华 。
登 金陵L 雨花台L 望 大江L	明	高启	石头城L 下 涛声 怒 ， 武骑 千群 谁敢 渡 ？ 黄旗 入洛 竟 何祥 ， 铁锁 横江 未 为固 。
西塞山L 怀古	唐	刘禹锡	王濬 楼船 下 益州L ， 金陵L 王气 黯然 收 。 千寻 铁锁 沉 江底 ， 一片 降幡 出 石头L 。
石头城L	宋	汪元量	石头城L 上 小 徘徊 ， 世换 僧残 寺 已灰 。 一片 降旗 千古 泪 ， 前人 留与 后人 哀 。
石头城L	宋	刘翰	离离 芳草 满 吴宫L ， 绿到 台城L 旧苑 东 。 一夜 空江 烟水 冷 ， 石头L 明月 雁声 中 。
晚登 清凉山L	清	袁枚	上山 访僧 僧寺 锁 ， 孤亭 荒荒 红日 堕 。 万家 炊烟 直 复斜 ， 几行 雁字 右 复左 。 长江L 半向 树梢 出 ， 石罅 尽教 落叶 裹 。 怪他 啼鸟 尽 惊飞 ， 唯有 白云 不 让我 。
陪 留守 余处恭P 、 总领 钱进思P 、 提刑 傅景仁P 游 清凉寺L 即 古 石头城L	宋	杨万里	万里 长江L 天上 来 ， 石头L 却欲 打 江回 ， 青山 外面 周 如削 ， 紫府 中间 划洞 开 。 苏峻P 战场 今 草树 ， 仲谋P 庙貌 古 尘埃 。 多情 白鹭洲L 前 水 ， 月落 潮生 声 自哀 。
泊 秦淮L	唐	杜牧	烟 笼 寒水 月 笼 沙 ， 夜泊 秦淮L 近 酒家 。 商女 不知 亡国 恨 ， 隔江 犹唱 后庭花 。
秦淮L 夜泊	宋	贺铸	官柳 动 春条 ， 秦淮L 生 暮潮 。 楼台 见 新月 ， 灯火 上 双桥 。 隔岸 开 朱箔 ， 临风 弄 紫箫 。 谁怜 远 游子 ， 心旆 正 摇摇 。
秦淮L	明	于慎行	秋月 秦淮L 岸 ， 江声 转 画桥 。 市楼 临 绮陌 ， 商女 驻 兰桡 。 云里 青丝 骑 ， 花间 碧玉 箫 。 不知 桃叶水L ， 流恨 几时 消 。
金陵L 五题·台城L	唐	刘禹锡	台城L 六代 竞 豪华 ， 结绮 临春 事 最奢 。 万户 千门 成 野草 ， 只缘 一曲 后庭花 。
台城L	唐	韦庄	江雨 霏霏 江草 齐 ， 六朝 如梦 鸟 空啼 。 无情 最是 台城L 柳 ， 依旧 烟笼 十里 堤 。
暮春 登 燕子矶L 怀古	明	林章	扬子江L 南 燕子矶L ， 杨花 燕子 一时 飞 。 六朝 人物 空 流水 ， 两晋 山川 尽 落晖 。 草色 远迷 瓜步L 去 ， 潮声 暗打 石头L 归 。 倚阑 天际 春 三月 ， 怅惆 东风 动 客衣 。
晓雨 后 登 燕子矶L 绝顶 作	清	王士祯	岷涛 万里 望 中收 ， 振策 危矶 最 上头 。 吴楚 青苍 分 极浦 ， 江山 平远 入 新秋 。 永嘉 南渡 人 皆尽 ， 建业L 西风 人 自流 。 洒泪 重悲 天堑 险 ， 浴凫 飞燕 满 汀洲 。
谒 明太祖P 陵	清	乾隆	崛起 何嫌 本 做僧 ， 汉高P 同杰 又 多能 。 每当 巡省 临 华里 ， 必致 勤虔 谒 孝陵L 。 一代 规模 颇 称树 ， 百年 礼乐 未遑 兴 。 独怜 复古 非 通变 ， 翻使 燕兵 衅 可乘 。
题 明太祖P 陵	清	赵翼	定鼎 金陵L 控制 遥 ， 宅中 方轨 集 轮镳 。 千秋 形胜 从 三国 ， 一样 江山 陋 六朝 。 燕啄 皇孙 传 岂误 ， 狗烹 诸将 乱 终消 。 桥陵L 曾借 神僧 穴 ， 易代 犹闻 禁 采樵 。
登 钟山L 下峰 望	南北朝	虞骞	冠者 五六 人 ， 携手 岩 之际 。 散意 百仞 端 ， 极目 千里 睇 。 叠岫 乍 昏明 ， 浮云 时 卷闭 。 遥看 野树 短 ， 远望 樵人 细 。
游 钟山L	宋	王安石	两山 松栎 暗 朱藤 ， 一水 中间 胜 武陵L 。 午梵 隔云 知 有寺 ， 夕阳 归去 不逢 僧 。
登 蒋山L	明	乌斯道	坐镇 皇州L 势 独雄 ， 英英 紫气 散 晴峰 。 龙蟠 实为 金陵L 重 ， 鹤怨 曾因 蕙帐 空 。 云拥 禅关 新建 塔 ， 花明 潜邸 旧 行宫 。 试临 绝顶 闲 凭眺 ， 锦绣 山河 感慨 中 。
最高 峰 登眺	清	姚鼐	已上 嶕峣 又 佛台 ， 正逢 秋霁 夕阳 开 。 地穷 江海 与 天际 ， 山自 岷嶓L 夹水 来 。 南国 中原 同 下俯 ， 华林 衰草 几千 回 。 何当 住此 云霄 上 ， 长与 星房 日驭 陪 。
玄武湖L	明	朱孟震	玄武湖L 头 春 可怜 ， 绕堤 花柳 媚 遥天 。 风微 凫鹭 参差 下 ， 日丽 楼台 紫翠 连 。 龙气 深秋 晴 似雨 ， 马蹄 芳草 暖 浮烟 。 白云 自是 神仙 署 ， 谁道 蓬莱L 弱水 边 ？
元武湖L	清	吴伟业	覆舟L 西望 接 陂陀 ， 千顷 澄潭 长 绿莎 。 六代 楼船 供 士女 ， 百年 版籍 重 山河 。 平川 岂习 昆明L 战 ， 禁地 须通 太液L 波 。 烟水 不关 兴废 感 ， 夕阳 闻 已 唱 渔歌 。
覆舟山L 下 作	清	屈大均	千年 龙虎 国 ， 怅望 一 平芜 。 六代 频 兴废 ， 中华 更 有无 。 大江L 流 王气 ， 遗殿 怨 栖乌 。 玉树 歌 良苦 ， 英雄 莫 据吴 。
汴河L 亭	唐	许浑	广陵L 花盛 帝 东游 ， 先劈 昆仑L 一派 流 。 百二 禁兵 辞 象阙 ， 三千 宫女 下 龙舟 。 凝云 鼓震 星辰 动 ， 拂浪 旗开 日月 浮 。 四海 义师 归 有道 ， 迷楼 还似 景阳楼L 。
汴河L	唐	汪遵	隋皇P 意欲 泛 龙舟 ， 千里 昆仑L 水 别流 。 还待 春风 锦帆 暖 ， 柳阴 相送 到 迷楼 。
汴河L 直 进船	唐	李敬方	汴水L 通淮 利 最多 ， 生人 为害 亦 相和 。 东南 四十三 州 地 ， 取尽 膏脂 是 此河 。
汴河L 怀古	唐	皮日休	尽道 隋亡 为 此河 ， 至今 千里 赖 通波 。 若无 水殿 龙舟 事 ， 共 禹 论功 不较多 。
汴河L 怀古	明	李濂	黄河L 回流 宋 神州L ， 聒耳 涛声 日夜 流 。 堤柳 似知 朝代 改 ， 半含 烟雨 半含 愁 。
维扬L 怀古	明	曾棨	广陵L 城里 昔 繁华 ， 炀帝P 行宫 接 紫霞 。 玉树 歌残 犹 有曲 ， 锦帆 归去 已 无家 。 楼台 处处 迷 芳草 ， 风雨 年年 怨 落花 。 最是 多情 汴堤 柳 ， 春来 依旧 带 栖鸦 ！
隋宫L	清	陈恭尹	穀洛L 通淮 日夜 流 ， 渚荷 宫树 不曾 秋 。 繁华 往事 邗沟L 外 ， 风起 杨花 无 那愁 。
寄 扬州L 韩绰判官P	唐	杜牧	青山 隐隐 水 迢迢 ， 秋尽 江南L 草 未凋 。 二十四 桥 明月 夜 ， 玉人 何处 教 吹箫 。
夜看 扬州市L	唐	王建	夜市 千灯 照 碧云 ， 高楼 红袖 客 纷纷 。 如今 不似 时 平日 ， 犹自 笙歌 彻晓 闻 。
纵游 淮南L	唐	张祜	十里 长街 市井 连 ， 月明 桥上 看 神仙 。 人生 只合 扬州L 死 ， 禅智L 山光 好 墓田 。
忆 扬州L	唐	徐凝	萧娘P 脸薄 难 胜泪 ， 桃叶P 眉尖 易 觉愁 。 天下 三分 明月 夜 ， 二分 无赖 是 扬州L 。
宿 扬州L	唐	李绅	江横 渡阔 烟波 晚 ， 潮过 金陵L 落叶 秋 。 嘹唳 塞鸿 经 楚泽 ， 浅深 红树 见 扬州L 。 夜桥 灯火 连 星汉 ， 水郭 帆樯 近 斗牛 。 今日 市朝 风俗 变 ， 不须 开口 问 迷楼 。
送 邓漕P 移帅 扬州L	宋	周必大	闻道 维扬L 地望 雄 ， 风流 人物 似 江东L 。 六龙 前日 临 淮海L ， 五马 由来 说 醉翁 。 璧月 几桥 留 夜色 ， 珠帘 十里 待 春风 。 遥知 九月 平山会 ， 笑插 茱萸 满鬓红 。
春日 扬州L	唐	姚合	江北L 烟光 里 ， 淮南L 胜事 多 。 春风 荡 城郭 ， 满耳 是 笙歌 。
平山堂L	清	金农	廿四 桥边 廿四 风 ， 凭栏 犹忆 旧 江东L 。 夕阳 返照 桃花渡L ， 柳絮 飞来 片片 红 。
平山堂L	明	文征明	平山堂L 上 草 芊绵 ， 学士 风流 五百 年 。 往事 难追 嘉佑 迹 ， 闲情 聊试 大明泉L 。 隔江 秀色 千峰 雨 ， 落日 平林 万井 烟 。 最是 登临 易 生感 ， 归心 摇落 片帆 前 。
长春湖L	清	汪沆	垂杨 不断 接 残芜 ， 雁齿 虹桥 俨 画图 。 也是 销金 一 锅子 ， 故应 唤作 瘦西湖L 。
浣溪沙 · 红桥L 怀古	清	王士祯	北郭 清溪 一带 流 ， 红桥L 风物 眼中 秋 ， 绿杨 城郭 是 扬州L 。 西望 雷塘L 何处 是 ？ 香魂 零落 使人 愁 ， 淡烟 芳草 旧 迷楼 。
红桥L 秋泛	清	陈文述	面面 垂杨 面面 风 ， 画桥L 西北 画楼 东 。 夕阳 只在 栏干 外 ， 一半 芙蓉 水上 红 。
秋日 登 扬州L 西灵塔L	唐	李白	宝塔 凌 苍苍 ， 登攀 览 四荒 。 顶高 元气 合 ， 标出 海云长 。 万象 分空界 ， 三天 接 画梁 。 水摇 金刹 影 ， 日动 火珠 光 。
与 梦得P 同登 栖灵塔L	唐	白居易	半月 悠悠 在 广陵L ， 何楼 何塔 不 同登 。 共怜 筋力 犹 堪在 ， 上到 栖灵L 第九 层 。
同 乐天P 登 栖灵寺L 塔	唐	刘禹锡	步步 相携 不觉 难 ， 九层 云外 倚 阑干 。 忽然 笑语 半天 上 ， 无限 游人 举眼 看 。
拜墓	清	王士祯	梅花岭L 外 夕阳 时 ， 步屧 重来 有 所思 。 异代 衣冠 余蔓草 ， 千年 伏腊 只 荒祠 。 芜城L 落日 人烟 杳 ， 瓜步L 清秋 戍角 悲 。 萧瑟 西风 松柏树 ， 春来 犹发 向 南枝 。
隋宫L	唐	李商隐	紫泉 宫殿 锁 烟霞 ， 欲取 芜城L 作 帝家 。 玉玺 不缘 归 日角 ， 锦帆 应是 到 天涯 。 于今 腐草 无 萤火 ， 终古 垂杨 有 暮鸦 。 地下 若逢 陈后主P ， 岂宜 重问 后庭花 。
炀帝陵L	唐	罗隐	入郭 登桥 出郭 船 ， 红桥L 日日 柳 年年 。 君王 忍把 平陈 业 ， 只博 雷塘L 数亩 田 。
杨柳 枝	唐	刘禹锡	炀帝P 行宫 汴水L 滨 ， 数株 残柳 不胜 春 。 晚来 风起 花 如雪 ， 飞入 宫墙 不见 人 。
经 炀帝P 行宫	唐	刘沧	此地 曾经 翠辇 过 ， 浮云 流水 竟 如何 。 香销 南国 美人 尽 ， 怨入 东风 芳草 多 。 残柳 宫前 空 露叶 ， 夕阳 川上 浩 烟波 。 行人 遥起 广陵L 思 ， 古渡 月明 闻 棹歌 。
雨中 题壁	宋	张耒	去年 此日 泊 瓜州L ， 衰柳 萧萧 系 客舟 。 白发 天涯 叹 流落 ， 今年 对雨 古 宣州L 。
瓜洲L 晚渡	宋	方岳	天地 中间 一叶 舟 ， 与鸥 等是 此生 浮 。 江淮 千里 水天 碧 ， 南北 六朝 烟树 愁 。 浪挟 禹功 吞 巨海 ， 寺骑 娲石 碍中 流 。 渔蓑 不涉 兴亡事 ， 自醉 自醒 今 白头 。
题 金陵渡L	唐	张祜	金陵津渡L 小山楼 ， 一宿 行人 自 可愁 。 潮落 夜江 斜月 里 ， 两三 星火 是 瓜州L 。
芙蓉楼L 送 辛渐P	唐	王昌龄	寒雨 连江 夜 入 吴 ， 平明 送客 楚山L 孤 。 洛阳L 亲友 如 相问 ， 一片 冰心 在 玉壶 。
瓜州L 渡江	清	王士祯	昨上 京江 北固楼L ， 微茫 风日 见 瓜州L 。 层层 远树 浮 清荠 ， 叶叶 轻帆 起 白鸥 。 扬子L 桥头 鸡 未鸣 ， 瓜州L 城外 日 东升 。 风波 不惮 西 津渡L ， 一见 金焦L 双眼 明 。
润州L	清	徐永宣	江山 谁 第一 ？ 最是 润州城L 。 山上 南朝寺L ， 江头 北府 兵 。 三春 添 黛色 ， 万古 一 涛声 。 阅尽 东西 客 ， 劳劳 役利 名 。
丹阳L 怀古	宋	邵彪	故里 诗人 去 ， 湖山 最 寂寥 。 草深 张祜P 宅 ， 花暗 许浑P 桥 。 凤髓 何时 续 ， 蓬萍 触处 飘 。 鸿冥 杳 难及 ， 霜鬓 两 萧萧 。
题 润州L 金山寺L	唐	张祜	一宿 金山寺L ， 超然 离 世群 。 僧归 夜船 月 ， 龙出 晓堂 云 。 树色 中流 见 ， 钟声 两岸 闻 。 翻思 在 朝市 ， 终日 醉醺醺 。
题 金山寺L	唐	孙鲂	万古 波心寺L ， 金山L 名目 新 。 天多 剩得 月 ， 地少 不 生尘 。 过橹 妨僧 定 ， 惊涛 溅 佛身 。 谁言 张处士P ， 题后 更 无人 。
金山寺L	宋	王令	万顷 清江 浸 碧山 ， 乾坤 都向 此中 宽 。 楼台 影落 鱼龙 骇 ， 钟磬 声来 水石 寒 。 日暮 海门 飞 白鸟 ， 潮回 瓜步L 见 黄滩 。 当时 户外 风波 恶 ， 只得 高僧 静处 看 。
登 金山L	元	冯子振	双塔 嵯峨 耸 碧空 ， 烂银 堆 里 紫金峰 。 江流 吴楚 三千 里 ， 山压 蓬莱L 第一 宫 。 云外 楼台 迷 鸟雀 ， 水边 钟鼓 振 蛟龙 。 问僧 何处 风涛 险 ？ 郭璞P 坟前 浪打 风 。
登 金山L	清	王士祯	振衣 直上 江天阁L ， 怀古 仍登 海岳楼L 。 三楚 风涛 杯底 合 ， 九江 云物 坐中 收 。 石簰 落照 翻 孤影 ， 玉带 山门 访 旧游 。 我醉 吟诗 最高 顶 ， 蛟龙 惊起 暮潮 秋 。
金山L	清	潘耒	万古 标 形胜 ， 中江 一柱 尊 。 水分 天 作堑 ， 地坼 海 为门 。 钟磬 来 波面 ， 蛟龙 聚 塔根 。 蕲王P 血战 处 ， 坠马 有 惊魂 。
登 金山L 寺塔	宋	王安石	数重 楼枕 层层 石 ， 四壁 窗开 面面 风 。 忽见 鸟飞 平地 上 ， 始惊 身在 半空 中 。 插云 金碧 虹 千丈 ， 倚汉 峥嵘 玉 一峰 。 想得 高秋 凉 月夜 ， 分明 人世 蕊珠宫L 。
次 北固山L 下	唐	王湾	客路 青山 外 ， 行舟 绿水 前 。 潮平 两岸 阔 ， 风正 一帆 悬 。 海日 生 残夜 ， 江春 入 旧年 。 乡书 何处 达 ？ 归雁 洛阳L 边 。
永遇乐 · 京口L 北固亭L 怀古	宋	辛弃疾	千古 江山 ， 英雄 无觅 ， 孙仲谋P 处 。 舞榭 歌台 ， 风流 总被 ， 雨打 风吹 去 。 斜阳 草树 ， 寻常 巷陌 ， 人道 寄奴P 曾住 。 想 当年 ， 金戈 铁马 ， 气吞 万里 如虎 。 元嘉 草草 ， 封 狼居胥L ， 赢得 仓皇 北顾 。 四十三 年 ， 望中 犹记 ， 烽火 扬州L 路 。 可堪 回首 ， 佛狸祠L 下 ， 一片 神鸦 社鼓 。 凭 谁问 ： 廉颇P 老矣 ， 尚能 饭否 ？
多景楼L 呈 某使君P	北宋	米芾	六代 萧萧 木叶 稀 ， 楼高 北固L 落 残晖 。 两州 城郭 青烟 起 ， 千里 江山 白鹭 飞 。 海近 云涛 惊 夜梦 ， 天低 月露 溼 秋衣 。 使君 肯负 清时 乐 ， 长倒 金钟 尽醉 归 。
登 多景楼L	宋	刘过	壮观 东南 二百 州 ， 景于 多处 最多 愁 。 江流 千古 英雄 泪 ， 山掩 诸公 富贵 羞 。 北固L 怀人 频 对酒 ， 中原 在望 莫 登楼 。 西风 战舰 成 何事 ， 空送 年年 使客舟 。
寄题 甘露寺L 北轩	唐	杜牧	曾向 蓬莱宫L 里 行 ， 北轩 阑槛 最 留情 。 孤高 堪弄 桓伊P 笛 ， 缥缈 宜闻 子晋P 笙 。 天接 海门L 秋水 色 ， 烟笼 隋苑L 暮钟 声 。 他年 会 著 荷衣 去 ， 不向 山僧 说 姓名 。
甘露寺L	宋	晁端友	北固L 山头 寺 ， 风烟 昔 纵观 。 卧亭 秋石狠 ， 环舍 海涛 寒 。 越舶 楼前 聚 ， 江枫 户外 丹 。 最宜 清 夜月 ， 虚阁 忆 盘桓 。
焦山L 望 松寥山L	唐	李白	石壁 望 松寥L ， 宛然 在 碧霄 。 安得 五彩 虹 ， 驾天 作 长桥 。 仙人 如 爱我 ， 举手 来 相招 。
焦山寺L	宋	林景熙	山裹 中流 小 梵林 ， 宝莲 鳌背 翠 沈沈 。 半空 但觉 烟岚 合 ， 三面 不知 风浪 深 。 仙井L 浴丹 开晓 日 ， 海门L 浮玉L 澹秋 阴 。 洞深 瑶草 无人 采 ， 瘗鹤 残碑 浸 碧浔 。
游 焦山寺L	元	周伯琦	涉江 已阅 裴公洞L ， 复访 焦先 到 此山 。 险绝 远同 巴蜀峡L ， 岿然 对峙 海门关L 。 神蛟 戏浪 时 潜跃 ， 野鸟 巢林 自 往还 。 建业L 青山 广陵L 树 ， 开轩 尽在 酒壶 间 。
重游 焦山L	明	杨一清	洞口 孤云 面面 生 ， 百年 身世 坐来 清 。 一船 月色 金山寺L ， 十里 烟光 铁瓮城L 。 江阁 雨余 秋水 阔 ， 海门L 风定 暮潮 平 。 青衫 潦倒 虚名 在 ， 耻向 沙鸥 问 旧盟 。
太湖L 秋夕	唐	王昌龄	水宿 烟雨 寒 ， 洞庭L 霜落 微 。 月明 移舟 去 ， 夜静 魂梦 归 。 暗觉 海风 度 ， 萧萧 闻 雁飞 。
宿 湖中	唐	白居易	水天 向晚 碧 沉沉 ， 树影 霞光 重叠 深 。 浸月 冷波 千顷 练 ， 苞霜 新橘 万株 金 。 幸无 案牍 何妨 醉 ， 纵有 笙歌 不 废吟 。 十只 画船 何处 宿 ， 洞庭L 山脚 太湖L 心 。
秋日 湖上	唐	薛莹	落日 五湖L 游 ， 烟波 处处 愁 。 浮沉 千古 事 ， 谁与 问 东流 。
望 太湖L	宋	苏舜钦	杳杳 波涛 阅 古今 ， 四边 无际 莫 知深 。 润通 晓月 为 清露 ， 气入 霜天 作 暝阴 。 笠泽L 鲈肥 人 脍玉 ， 洞庭L 柑熟 客 分金 。 风烟 触目 相 招引 ， 聊为 停桡 一 楚吟 。
题 周文翰P 郭熙P 山水 二首	宋	张耒	洞庭L 叶落 万波 秋 ， 说与 南人 亦 自愁 。 指点 吴江L 何处 是 ， 一行 鸿雁 海 山头 。
游 太湖L	明	文征明	岛屿 纵横 一 镜中 ， 湿银 盘紫 漫 芙蓉 。 谁能 胸贮 三万 顷 ， 我欲 身游 七十 峰 。 天远 洪涛 翻 日月 ， 春雨 泽国 隐 鱼龙 。 中流 仿佛 闻 鸡犬 ， 何处 堪追 范蠡P 踪 。
泛 太湖L	明	唐寅	具区L 浩荡 波 无极 ， 万顷 湖光 尽 凝碧 。 青山 点点 望中 微 ， 寒空 倒侵 连天 白 。 羝夷P 一去 经 千年 ， 至近 高韵 人 尤传 。 吴越 兴亡 付 流水 ， 空留 月照 洞庭L 船 。 
泛舟 太湖L	清	王鼎	双帆 剪破 碧 玻璃 ， 秋色 空濛 望 欲迷 。 七十二 峰 何处 好 ， 夕阳 一角 洞庭L 西 。
嘲 范蠡P	宋	郑獬	千重 越甲 夜 城围 ， 宴罢 君王 醉 不知 。 若论 破吴 功 第一 ， 黄金 只合 铸 西施P 。
松江L 舟中 四首	宋	戴复古	垂虹L 五百 步 ， 太湖L 三万 顷 。 除却 岳阳楼L ， 天下 无 此景 。 范蠡P 挟 西施P ， 功名 付 烟艇 。
蠡湖L 水居	明	高攀龙	有客 风尘 归去来 ， 兀然 孤坐 水中台 。 九龙山L 似 翠屏 立 ， 五里湖L 如 明镜 开 。 春雨 鳜肥 菰米饭 ， 秋风 鲈美 菊花杯 。 蒹葭 白露 伊人 在 ， 恣问 江天 亦 快哉 ！
别 石泉L	唐	李绅	素沙 见底 空 无色 ， 青石 潜流 暗 有声 。 微渡 竹风 涵 淅沥 ， 细浮 松月 透 轻明 。 桂凝 秋露 添 灵液 ， 茗折 香芽 泛 玉英 。 应是 梵宫 连 洞府 ， 浴池L 今化 醴泉 清 。
惠山L 谒 钱道人P ， 烹 小龙团 ， 登 绝顶 望 太湖L	北宋	苏轼	踏遍 江南L 南岸 山 ， 逢山 未免 更 留连 。 独携 天上 小团月 ， 来试 人间 第二 泉 。 石路 萦回 九龙脊L ， 水光 翻动 五湖L 天 。 孙登P 无语 空 归去 ， 半岭 松声 万壑 传 。
潘葑L 回望 惠山L 真如 龙形	南宋	杨万里	惠山L 分明 龙样 活 ， 玉脊 琼腰 百千 折 。 锡山L 泉止 吐 一珠 ， 簸弄 太湖L 波底 月 。 苍石 为角 松 为须 ， 须里 黄金 古 佛珠 。 请君 更向 潘葑L 看 ， 龙尾 激到 珠南 畔 。
登 阊门L 闲望	唐	白居易	阊门L 四望 郁苍苍 ， 始知 州雄 土俗强 。 十万 夫家 供 课税 ， 五千 子弟 守 封疆 。 阊闾L 城碧 铺 秋草 ， 乌鹊 桥红 带 夕阳 。 处处 楼前 飘管 吹 ， 家家 门外 泊舟 航 。 云埋 虎寺L 山 藏色 ， 月耀 娃宫L 水 放光 。 曾赏 钱塘L 嫌 茂苑L ， 今来 未敢 苦 夸张 。
送人 游吴	唐	杜荀鹤	君到 姑苏L 见 ， 人家 尽 枕河 。 古宫 闲地 少 ， 水港 小桥 多 。 夜市 卖 菱藕 ， 春船 载 绮罗 。 遥知 未眠 月 ， 乡思 在 渔歌 。
乌栖 曲	唐	李白	姑苏台L 上 乌栖 时 ， 吴王宫L 里 醉 西施P 。 吴歌 楚舞 欢 未毕 ， 青山 欲衔 半边 日 。 银箭 金壶 漏水 多 ， 起看 秋月 坠 江波 。 东方 渐高 奈 乐 何 ！
苏台L 竹枝词	元	杨维桢	姑苏台L 上 月 团团 ， 姑苏台L 下 水 潺潺 。 月落 西边 有时 出 ， 水流 东去 几时 还 。
登 阖闾L 古城	唐	武元衡	登高 望远 自 伤情 ， 柳发 花开 映 古城 。 全盛 已随 流水 去 ， 黄鹂 空啭 旧 春声 。
散步	明	唐寅	吴王城L 里 柳 成畦 ， 齐女门L 前 水 拍堤 。 卖酒 当垆 人 袅娜 ， 落花 流水 路 东西 。 平头 衣袜 和鞋 试 ， 弄舌 钩辀 绕树 啼 。 此是 吾生 行乐 处 ， 若为 诗句 不 留题 。
姑苏L 曲	明	刘崧	姑苏L 城头 乌 夜啼 ， 姑苏台L 上 风 凄凄 。 鸳鸯 飞去 屧廊 空 ， 犹唱 吴宫L 旧时 曲 。
阖闾城L 怀古	唐	刘瑶	五湖L 春水 接 遥天 ， 国破 君亡 不 记年 。 唯有 妖娥 曾 舞处 ， 古台 寂寞 起 愁烟 。
初晴 游 沧浪亭L	宋	苏舜钦	夜雨 连明 春水 生 ， 娇云 浓暖 弄 阴晴 。 帘虚 日薄 花竹 静 ， 时有 乳鸠 相对 鸣 。
沧浪池L 上	明	文征明	杨柳 阴阴 十亩 塘 ， 昔人 从此 咏 沧浪L 。 春风 依旧 吹 芳杜 ， 陈迹 无多 半 夕阳 。 积雨 经时 荒渚 断 ， 跳鱼 一聚 晚波 凉 。 渺然 诗思 江湖 近 ， 便欲 相携 上 野航 。
戊寅 岁元 夕 网师园L 张灯 合乐 即事	清	彭启丰	试灯 佳节 卷 晶帘 ， 把盏 征歌 韵事 兼 。 梅圃 雪飘 封 玉树 ， 冰池 云散 露 银蟾 。 星桥 乍架 春 初转 ， 画舫 新移 景 又添 。 漫听 村南 喧鼓 吹 ， 家家 竹马 驻 茅檐 。
枫桥L 夜泊	唐	张继	月落 乌啼 霜 满天 ， 江枫 渔火 对 愁眠 。 姑苏城L 外 寒山寺L ， 夜半 钟声 到 客船 。
过 枫桥寺L 示 迁老P	宋	孙觌	白首 重来 一梦 中 ， 青山 不改 旧时 容 。 乌啼 月落 桥边 寺 ， 欹枕 犹闻 半夜 钟 。
泊 枫桥L	明	高启	画桥 三百 映 江城L ， 诗里 枫桥L 独 有名 。 几度 经过 忆 张继P ， 乌啼 月落 又 钟声 。
姑苏L 八咏 寒山寺L	明	唐寅	金阊门L 外 枫桥L 路 ， 万家 月色 迷 烟雾 。 谯阁 更残 角韵 悲 ， 客船 夜半 钟声 度 。 树色 高低 混 有无 ， 山光 远近 成 模糊 。 霜华 满天 人 怯冷 ， 江城L 欲曙 闻 啼乌 。
夜雨 题 寒山寺L 寄 西樵P 、 礼吉P	清	王士祯	日暮 东塘 正 落潮 ， 孤篷 泊处 雨 潇潇 。 疏钟 夜火 寒山寺L ， 记过 枫桥L 第几 桥 ？ 枫叶 萧条 水驿 空 ， 离居 千里 怅 难同 。 十年 旧约 江南L 梦 ， 独听 寒山L 半夜 钟 。
题 东武丘寺L 六韵	唐	白居易	香刹 看 非远 ， 祇园 入 始深 。 龙蟠 松 矫矫 ， 玉立 竹 森森 。 怪石 千僧 坐 ， 灵池 一剑 沉 。 海当亭L 两面 ， 山在 寺 中心 。
游 虎丘寺L	宋	王禹偁	寺墙 围著 碧 孱颜 ， 曾是 当年 海涌山L 。 尽把 好峰 藏 院里 ， 不教 幽景 落 人间 。 剑池 草色 经冬 在 ， 石座 苔花 自古 斑 。 珍重 晋朝 吾 祖宅 ， 一回 来此 便 忘还 。
和 虚堂禅师P 韵	明	顾梦麟	百尺 苍凉 浸 石扉 ， 斗间 夜夜 湛 余辉 。 龙泉L 便是 池中 水 ， 不遇 风胡 见 却稀 。
三月三日T 重游 虎丘L	元	郭麟孙	细雨 霏霏 不 湿衣 ， 山前 山后 乱莺 飞 。 过桥 春色 绯 桃树 ， 临水 人家 白 板扉 。 此地 酒帘 邀我 醉 ， 隔船 箫鼓 送人 归 。 清游 恐尽 今朝 乐 ， 回首 阊门L 又 夕晖 。
苏台L 览古	唐	李白	旧苑 荒台 杨柳 新 ， 菱歌 清唱 不胜 春 。 只今 惟有 西江月 ， 曾照 吴王宫L 里 人 。
游 灵岩L	唐	张继	灵岩L 有路 入 烟霞 ， 台殿 高低 释子家 。 风满 回廊 飘 坠叶 ， 水流 绝涧 泛 秋花 。 青松 阅世 风霜 古 ， 翠竹 题诗 岁月 赊 。 谁谓 无生 真 可学 ， 山中 亦自 有 年华 。
灵岩寺L	唐	白居易	馆娃宫L 畔 千年 寺 ， 水阔 云多 客到 稀 。 闻说 春来 更 惆怅 ， 百花 深处 一僧 归 。
吴宫L 怀古	唐	陆龟蒙	香径L 长洲L 尽 棘丛 ， 奢云 艳雨 只 悲风 。 吴王P 事事 须 亡国 ， 未必 西施P 胜 六宫 。
题 馆娃宫L 诗	明	高启	馆娃宫L 中 馆娃阁L ， 画栋 侵云 峰顶 开 。  犹恨 当年 高 未极 ， 不能 望见 越兵 来 。
馆娃宫L	明	梁小玉	江有 鸱夷P 霸气 空 ， 还从 余址 想 雄风 。 浪传 西子P 能 倾国 ， 谁识 东吴P 自 造穷 。 歌舞 化成 蛙 两部 ， 绮罗 番作 薜 千丛 。 受恩 深处 芳魂 在 ， 清血 年年 杜宇 红 。
张公洞L	宋	苏辙	乱山 深处 白云 堆 ， 地坼 中空 洞府 开 。 茧瓮 有天 含 宇宙 ， 瑶台 无路 接 蓬莱L 。 金芝 春暖 青牛 卧 ， 珠树 月明 黄鹤 回 。 此日 登临 兴 何限 ， 春风 吹绽 碧桃 腮 。
登 广武L 古 战场 怀古	唐	李白	秦鹿 奔 野草 ， 逐之 若 飞蓬 。 项王P 气 盖世 ， 紫电 明 双瞳 。 呼吸 八千 人 ， 横行 起 江东L 。 赤精 斩 白帝 ， 叱咤 入 关中 。 两龙 不 并跃 ， 五纬 与天 同 。 楚灭 无 英图 ， 汉兴 有 成功 。 按剑 清 八极 ， 归酣 歌 大风 。
题 歌风台L	宋	张方平	落魄 刘邦P 作帝 归 ， 樽前 感慨 大风辞 。 淮阴P 反接 英彭P 族 ， 更欲 多求 猛士 为 ？
歌风台L 和 李提P 举韵	元	揭傒斯	万乘 东归 火德 开 ， 汉皇P 曾此 宴 高台 。 沛中 父老 讴歌 下 ， 海内 英雄 倒载 回 。 汤沐 空余 清泗L 在 ， 风云 犹以 翠华 来 。 穹碑 立断 苍烟 上 ， 静阅 人间 几 劫灰 。
沛县L 过 高帝庙L	明	陶望龄	路经 旧沛 山川 古 ， 龙起 中原 战斗 多 。 一代 雄图 开 赤帝P ， 千秋 遗庙 傍 黄河L 。 云归 尚识 真人 气 ， 风起 犹传 猛士 歌 。 魂魄 来游 长 此地 ， 汉宫 秋色 近 如何 。
歌风台L	金	刘昂	刘项P 兴亡 转烛 过 ， 乱蝉 吟破 汉 山河 。 长陵L 卧老 咸阳L 月 ， 沛上 犹传 击筑歌 。
咏 歌风台L	明	陈史女	击筑歌 风韵 最哀 ， 白云 终古 傍 高台 。 平生 戎马 剑 三尺 ， 满目 江河 酒 一杯 。 父老 浑忘 天子 贵 ， 英雄 犹恋 故乡 来 。 弓藏 鸟尽 嗟 何及 ， 想到 韩彭P 惜 将才 。
题 韩信庙L	明	骆用卿	逐鹿 中原 汉力 微 ， 登坛 频蹙 楚军 威 。 足当 蹑足 犹 分土 ， 心已 猜时 尚 解衣 。 毕竟 封侯 符 蒯彻P ， 几曾 握手 到 陈豨P 。 英魂 漫洒 荒山 泪 ， 秋草 长陵L 久 落晖 。
题 韩信庙L	宋	钱若水	筑坛 拜处 恩 虽厚 ， 蹑足 封时 虑 已深 。 隆淮 若知 同 鸟喙 ， 将军 应有 五湖L 心 。
猛虎 行	唐	李白	张良P 未遇 韩信P 贫 ， 刘项P 存亡 在 两臣 。
经 下邳L 圯桥L 怀 张子房P	唐	李白	子房P 未 虎啸 ， 破产 不 为家 。 沧海 得 壮士 ， 椎秦 博 浪沙 。 报韩 虽 不成 ， 天地 皆 振动 。 潜匿 游 下邳L ， 岂曰 非 智勇 ？ 我来 圯桥L 上 ， 怀古 钦 英风 。 唯见 碧 流水 ， 曾无 黄石公P 。 叹息 此人 去 ， 萧条 徐泗L 空 。
次韵 陈海州P 书怀	宋	苏轼	郁郁 苍梧L 海上 山 ， 蓬莱L 方丈L 有无 间 。 旧闻 草木 皆 仙药 ， 欲弃 妻孥 守 市阛 。 雅志 未成 空 自叹 ， 故人 相对 若 为颜 。 酒醒 却忆 儿童 事 ， 长恨 双凫 去 莫攀 。
登 云台山L	明	武尚行	苍梧L 绝顶 逼 三台 ， 化国 清都 海上 开 。 信是 尘寰 真 阆苑 ， 何须 弱水 问 蓬莱L 。 天连 齐鲁 千峰 绕 ， 地接 江淮 万里 来 。 徙倚 飞楼 时 极目 ， 自惊 身在 五云 堆 。
杭州L 春望	唐	白居易	望海楼L 明 照 曙霞 ， 护江 堤 白 踏 晴沙 。 涛声 夜入 伍员庙L ， 柳色 春藏 苏小P 家 。 红袖 织绫 夸 柿蒂 ， 青旗 沽酒 趁 梨花 。 谁开 湖寺 西南 路 ， 草绿 裙腰 一道 斜 。
答客 问 杭州L	唐	白居易	为我 踟蹰 停 酒盏 ， 与君 约略 说 杭州L 。 山名 天竺L 堆 青黛 ， 湖号 钱塘L 泻 绿油 。 大屋 檐多 装 雁齿 ， 小航 船 亦 画 龙头 。 所嗟 水路 无 三百 ， 官系 何因 得 再游 。
杭州L 回舫	唐	白居易	自别 钱塘L 山水 后 ， 不多 饮酒 懒 吟诗 。 欲将 此意 凭 回棹 ， 报与 西湖L 风月 知 。
钱塘L 曲	唐	温庭筠	钱塘L 岸上 春 如织 ， 渺渺 寒潮 带 晴色 。 淮南L 游客 马 连嘶 ， 碧草 迷人 归 不得 。 风飘 客意 如 吹烟 ， 纤指 殷勤 伤 雁弦 。 一曲 堂堂 红烛 筵 ， 长鲸 泻酒 如 飞泉 。
杭州L 呈 胜之P	宋	王安石	游观 须知 此地 佳 ， 纷纷 人物 敌 京华L 。 林峦 腊雪 千家 水 ， 城郭 春风 二月 花 。 彩舫 笙箫 吹 落日 ， 画楼 灯烛 映 残霞 。 如君 援笔 直 摹写 ， 寄与 尘埃 北客 夸 。
题 临安L 邸	宋	林升	山外 青山 楼外 楼 ， 西湖L 歌舞 几时 休 ？ 暖风 熏得 游人 醉 ， 直把 杭州L 作 汴州L 。
湖州L 歌	宋	汪元量	一掬 吴山L 在 眼中 ， 楼台 累累 间 青红 。 锦帆 后夜 烟江 上 ， 手抱 琵琶 忆 故宫 。
西湖L 竹枝词	元	于立	侬家 住在 涌金门L ， 青 见 高峰 白 见 云 。 岭上 已无 丞相宅L ， 湖边 犹有 岳王坟L 。
钱塘L 偶成	明	岑琬	画舫 行春 醉 欲迷 ， 湖山 好在 古城 西 。 不知 误国 人 何在 ， 杨柳 东风 鸟 自啼 。
钱塘L 怀古	清	朱芹忠	武林L 郁 苍苍 ， 山川 征 媚妩 。 千峰 拥 翠屏 ， 万家 歌 乐土 。 前白 与 后苏 ， 风流 勤政 抚 。 到处 多 留题 ， 芳声 辉 治谱 。
春 题 湖上	唐	白居易	湖上 春来 似 画图 ， 乱峰 围绕 水 平铺 。 松排 山面 千重 翠 ， 月点 波心 一颗 珠 。 碧毯 线头 抽 早稻 ， 青罗 裙带 展 新蒲 。 未能 抛得 杭州L 去 ， 一半 勾留 是 此湖 。
钱塘湖L 春行	唐	白居易	孤山寺L 北 贾亭L 西 ， 水面 初平 云脚 低 。 几处 早莺 争 暖树 ， 谁家 新燕 啄 春泥 。 乱花 渐欲 迷 人眼 ， 浅草 才能 没 马蹄 。 最爱 湖东 行 不足 ， 绿杨 阴里 白沙堤L 。
饮 湖上 初晴 后雨	宋	苏轼	水光 潋滟 晴 方好 ， 山色 空蒙 雨 亦奇 。 欲把 西湖L 比 西子P ， 淡妆 浓抹 总 相宜 。
晓出 净慈寺L 送 林子方P	宋	杨万里	毕竟 西湖L 六月 中 ， 风光 不与 四时 同 。 接天 莲叶 无穷 碧 ， 映日 荷花 别样 红 。
西湖L	金	任询	西湖L 环 武林L ， 澄澄 大 圆镜 ， 仰看 湖上 寺 ， 即是 镜中 影 。 湖光 与 天色 ， 一碧 千万 顷 。 堤径 截烟 来 ， 楼台 自 昏暝 。
题 江湖 伟观	宋	赵元清	凤舞 龙飞 王气 蟠 ， 两都赋 在 一 阑干 。 伍员P 不死 江潮 壮 ， 西子P 如生 越水L 寒 。 春日 百花 连 上苑 ， 秋风 落叶 满 长安L 。 钱塘L 尽占 东南 美 ， 河洛L 何人 著眼 看 。
西湖L	宋	于石	西湖L 胜概 甲 东南 ， 满眼 繁华 今 几年 。 钟鼓 相闻 南北 寺 ， 笙歌 不断 往来 船 。 山围 花柳 春风 地 ， 水浸 楼台 夜月 天 。 士女 只知 游赏 乐 ， 谁能 轸念 及 三边L 。
钱塘湖L 上	元	杨维桢	西子湖L 头 春色 浓 ， 望湖楼L 下 水 连空 。 柳条 千树 僧眼 碧 ， 桃花 一株 人面 红 。
西湖L 渔者	元	凌云翰	家住 钱唐L 西子湖L ， 钓竿 几度 拂 珊瑚 。 扁舟 载月 归来 晚 ， 不觉 全身 入 画图 。
和 友人 招游 西湖L	明	钟禧	万顷 西湖L 水 贴天 ， 芙蓉 杨柳 乱 秋烟 。 湖边 为问 山 多少 ？ 每个 峰头 住 一年 。
夏日 忆 西湖L	明	于谦	涌金门L 外 柳 如烟 ， 西子湖L 头 水 拍天 。 玉腕 罗裙 双 荡桨 ， 鸳鸯 飞近 采莲 船 。
西湖L 杂诗	清	黄任	珍重 游人 入 画图 ， 楼台 绣错 与 茵铺 。 宋家 万里 中原 土 ， 博得 钱塘L 十顷 湖 。 画罗 纨扇 总 如云 ， 细草 新泥 簇 蝶裙 。 孤愤 何关 儿女 事 ， 踏青 争上 岳王坟L ！
西湖L 垂柳 图	明	陈洪绶	外六桥L 头 杨柳 尽 ， 里六桥L 头 树 亦稀 。 真实 湖山 今 始见 ， 老迟 行过 更 依稀 。
西湖L	明	张杰	谁为 鸿濛 凿 此陂 ， 涌金门L 外 即 瑶池 。 平沙 水月 三千 顷 ， 画舫 笙歌 十二 时 。 今古 有诗 难 绝唱 ， 乾坤 无地 可 争奇 。 溶溶 漾漾 年年 绿 ， 销尽 黄金 总 不知 。
正月二十七T 雨中 过 苏堤L	宋	葛天民	一堤 杨柳 占 春风 ， 柳外 群山 细雨 中 。 人苦 未晴 浑 不到 ， 只宜 老眼 看 空濛 。
苏堤L 清明 即事	宋	吴惟信	梨花 风起 正 清明 ， 游子 寻春 半 出城 。 日暮 笙歌 收拾 去 ， 万株 杨柳 属 流莺 。
苏堤L 口号	清	沈受宏	六桥L 遥带 两峰 孤 ， 烟水 茫茫 旧 宋都 。 一向 岳王坟L 上 拜 ， 回头 不忍 见 西湖L 。
湖山 十景 · 平湖 秋月	宋	王洧	万顷 寒光 一席 铺 ， 冰轮 行处 片云 无 。 鹫峰L 遥度 西风 冷 ， 桂子 纷纷 点 玉壶 。
平湖 秋月	元	尹廷高	烂银盘 挂 六桥L 东 ， 色贯 玻璃 彻底 空 。 千顷 清光 无 着处 ， 夜深 分付 与 渔翁 。
湖山 十景 · 段桥L 残雪	宋	王洧	望湖亭L 外 半 青山 ， 跨水 修梁 影 亦寒 。 待伴 痕边 分 草色 ， 鹤惊 碎玉 吸 阑干 。
西湖L 断桥L 残雪	清	留松裔	湖旁 积雪 景 堪描 ， 点缀 春寒 属 断桥L 。 绝似 钱塘L 苏小小P ， 残妆 剩粉 不曾 消 。
南屏L 晚钟	清	侯铨	声暄 百八 起 西泠L ， 敲彻 斜阳 近 翠屏 。 闲逐 野云 停 半壑 ， 远随 孤棹 落 前汀 。 六桥L 金粉 人 初散 ， 十里 莺花 梦 乍醒 。 断续 听来 何处 好 ， 碧烟 明月 冷泉亭L 。
西湖L 晚归 回望 孤山寺L 赠 诸客	唐	白居易	柳湖 松岛 莲花 寺 ， 晚动 归桡 出 道场 。 卢橘 子 低 山雨 重 ， 棕榈 叶 战 水风 凉 。 烟波 澹荡 摇 空碧 ， 楼殿 参差 倚 夕阳 。 到岸 请君 回首 望 ， 蓬莱宫L 在 海 中央 。
腊日 游 孤山L 访 惠勤P 惠思P 二僧	宋	苏轼	天 欲雪 ， 云 满湖 ， 楼台 明灭 山 有无 。 水清 出石 鱼 可数 ， 林深 无人 鸟 相呼 。 腊日 不归 对 妻孥 ， 名寻 道人 实 自娱 。 道人 之居 在 何许 ？ 宝云山L 前 路 盘纡 。 孤山 孤绝 谁肯 庐 ？ 道人 有 道 山 不孤 。 作诗 火急 追 亡逋 ， 清景 一失 后 难摹 。
岳鄂王P 墓	元	赵孟頫	鄂王坟L 上 草 离离 ， 秋日 荒凉 石兽 危 。 南渡 君臣 轻 社稷 ， 中原 父老 望 旌旗 。 英雄 已死 嗟 何及 ， 天下 中分 遂 不支 。 莫向 西湖L 歌 此曲 ， 水光 山色 不胜 悲 。
岳忠武王P 祠	明	于谦	匹马 南来 渡 浙河L ， 汴城L 宫阙 远 嵯峨 。 中兴 诸将 谁 降敌 ， 负国 奸臣 主 议和 。 黄叶 古祠 寒雨 积 ， 清山 荒冢 白云 多 。 如何 一别 朱仙镇L ， 不见 将军 奏 凯歌 。
岳武穆王P 墓	宋	叶绍翁	万古 知心 只 老天 ， 英雄 堪恨 复 堪怜 。 如公 少缓 须臾 死 ， 此虏 安能 八十 年 。 漠漠 凝尘 空 偃月 ， 堂堂 遗像 在 凌烟 。 早知 埋骨 西湖L 路 ， 悔不 鸱夷P 理 钓船 。
岳武穆王P 墓	宋	王英孙	埋骨 西湖L 土 一丘 ， 残阳 荒草 几经 秋 。 中原 望断 因公 死 ， 北客 犹能 说 旧愁 。
岳武穆王P	元	宋无	克复 神州 指掌 间 ， 永昌陵L 侧 诏师 还 。 丹心 一片 栖霞L 月 ， 犹照 中原 万里 山 。
冷泉L	宋	林洪	一泓 清 可沁 诗脾 ， 冷暖 年来 只 自知 。 流出 西湖L 载 歌舞 ， 回头 不似 在 山时 。
灵隐寺L	明	朱仆	合涧桥L 头 水 ， 飞来洞L 口 山 。 鸟盘 苍壁 影 ， 僧掩 翠微 关 。 松露 昼 还滴 ， 岩花 秋 更斑 。 一年 尝 一到 ， 一到 一 忘还 。
酒泉子	宋	潘阆	长忆 西山L ， 灵隐寺L 前 三竺 后 ， 冷泉亭L 上 旧 曾游 ， 三伏 似 清秋 。 白猿 时见 攀 高树 ， 长啸 一声 何处 去 ？ 别来 几向 画阑 看 ， 终是 欠 峰峦 ！
十八涧L	清	朱彝尊	暮经 南山 南 ， 曲涧 一十八 。 山桥 往 而复 ， 山路 坱圠 兮 。 夕曛 渐 催人 ， 延首 望 香刹 。
九溪L 十八涧L	清	朱彝尊	寻遍 十五 寺 ， 九溪L 鸣 淙淙 。 下无 一寸 鱼 ， 上有 百尺 松 。 缘流 思 濯足 ， 奈此 菖蒲 茸 。
西湖L 竹枝	明	黄周星	山川 不改 仗 英雄 ， 浩气 能排 岱 麓松 。 岳少保L 同 于少保L ， 南 高峰 对 北 高峰 。
忆 西湖L	明	张煌言	梦里 相逢 西子湖L ， 谁知 梦醒 却 模糊 。 高坟 武穆P 连 忠肃P ， 添得 新祠 一座 无 。
入 武林L	明	张煌言	国亡 家破 欲 何之 ？ 西子湖L 头 有 我师 。 日月 双悬 于氏墓L ， 乾坤 半壁 岳家祠L 。 惭将 赤手 分 三席 ， 敢为 丹心 借 一枝 。 他日 素车 东 浙路 ， 怒涛 岂必 属 鸱夷 ！
于忠肃P 墓	清	沈祖孝	不读 先生 传 ， 谁知 社稷 危 。 中原 无 羌日 ， 少保P 大名 垂 。 独定 千秋 业 ， 偏留 万古 悲 。 自来 堕泪 碣 ， 宁止 岘山L 碑 ！
题 伍员庙L	唐	徐凝	千载 空祠 云海 头 ， 夫差P 亡国 已 千秋 。 浙波 只有 灵涛 在 ， 拜奠 青山 人 不休 。
谒 伍相祠L	明	高启	地老 天荒 伯业 空 ， 曾于 青史 见 遗功 。 鞭尸 楚墓 生前 孝 ， 抉目 吴门 死后 忠 。 魂压 怒涛 翻 白浪 ， 剑埋 冤血 起 腥风 。 我来 无限 伤心事 ， 尽在 越山L 烟雨 中 。
胥山L 伍员庙L	唐	常雅	苍苍 古庙 映 林峦 ， 漠漠 烟霞 覆 古坛 。 精魄 不知 何处 在 ， 威风 犹入 浙江L 寒 。
题 伍胥庙L	明	瞿佑	一过 丛祠 泪 满襟 ， 英雄 自古 少 知音 。 江边 敌国 方 尝胆 ， 台上 佳人 正 捧心 。 入郢 共知 仇 已雪 ， 沼吴 谁识 恨 尤深 ？ 素车 白马 终 何益 ， 不及 陶朱P 象 铸金 ！
浪淘沙	唐	刘禹锡	八月 涛声 吼 地 来 ， 头高 数丈 触 山 回 。 须臾 却入 海门L 去 ， 卷起 沙堆 似 雪堆 。
观 浙江L 涛	唐	徐凝	浙江L 悠悠 海西 绿 ， 惊涛 日夜 两 翻覆 。 钱塘 郭里 看潮 人 ， 直至 白头 看 不足 。
钱塘江L 潮	唐	罗隐	怒声 汹汹 势 悠悠 ， 罗刹江L 边 地 欲浮 。 漫道 往来 存 大信 ， 也知 反覆 向 平流 。
八月十五日T 看潮	北宋	苏轼	万人 鼓噪 慑 吴侬 ， 犹似 浮江 老 阿童 。 欲识 潮头 高 几许 ？ 越山L 浑在 浪花 中 。
观涛	宋	郑獬	怒涛 沃日 为之 阴 ， 下有 蛟龙 不测 深 。 若比 人间 恶 风浪 ， 长江L 风浪 本 无心 。
海潮 图	宋	楼钥	钱塘L 佳月 照 青霄 ， 壮观 仍看 半夜 潮 。 每恨 形容 无 健笔 ， 谁知 收拾 在 生绡 。
江潮	明	张舆	罗刹江L 头 八月 潮 ， 吞山 挟海 势 雄豪 。 六鳌 倒卷 银河 阔 ， 万马 横奔 雪嶂 高 。
送 王屋山人P 魏万P 还 王屋L	唐	李白	遥闻 会稽L 美 ， 一弄 耶溪L 水 。 万壑 与 千岩 ， 峥嵘 镜湖 里 。 秀色 不可 名 ， 清辉 满 江城L 。 人游 月边 去 ， 舟在 空中 行 。 此中 久 延伫 ， 入 剡 寻 王许 。
送 友人 寻 越中L 山水	唐	李白	闻道 稽山L 去 ， 偏宜 谢客P 才 。 千岩 泉 洒落 ， 万壑 树 萦回 。 东海 横 秦望L ， 西陵 绕 越台L 。 湖清 霜镜 晓 ， 涛白 雪山 来 。 八月 枚乘P 笔 ， 三吴 张翰P 杯 。 此中 多 逸兴 ， 早晚 向 天台L 。
酬 浙东L 李侍郎P 越州L 春晚 即事 长句	唐	刘禹锡	越中L 蔼蔼 繁华 地 ， 秦望L 峰前 禹穴L 西 。 湖草 初生 边雁 去 ， 山花 半谢 杜鹃 啼 。 青油 昼卷 临 高阁 ， 红旆 晴翻 绕 古堤 。 明日 汉庭 征 旧德 ， 老人 争出 若 耶溪L 。
回乡 偶书 二首	唐	贺知章	少小 离家 老大 回 ， 乡音 无改 鬓毛 衰 。 儿童 相见 不 相识 ， 笑问 客从 何处 来 。 离别 家乡 岁月 多 ， 近来 人事 半 消磨 。 惟有 门前 镜湖L 水 ， 春风 不改 旧时 波 。
送 贺宾客P 归越	唐	李白	镜湖L 流水 漾 清波 ， 狂客 归舟 逸兴 多 。 山阴L 道士 如 相见 ， 应写 黄庭 换 白鹅 。
赋得 越山L 越水L	元	李孝光	贺家湖L 上 又 秋风 ， 放翁P 宅前 东 复东 。 两行 云树 忽 远近 ， 十里 荷花 能 白红 。 游人 濯足 银河 上 ， 越女 梳头 青镜 中 。 我欲 张帆 上 南斗 ， 扶桑 碧海 与天 通 。
山阴L	明	袁宏道	钱塘L 艳 若花 ， 山阴L 芊 如草 。 六朝 以上 人 ， 不闻 西湖L 好 。
会稽山L 中	宋	戴复古	晓风 吹断 花稍 雨 ， 青山 白云 无 唾处 。 岚光 滴翠 湿 人衣 ， 踏碎 琼瑶 溪上 步 。 人家 远近 屋 参差 ， 半成 图画 半成 诗 。 若使 山中 无 杜宇 ， 登山 临水 定 忘归 。
兰亭L	宋	陆游	兰亭L 绝境 擅 吾州 ， 病起 身闲 得 纵游 。 曲水L 流觞L 千古 胜 ， 小山 丛桂 一年 秋 。 酒酣 起舞 风前 袖 ， 兴尽 回桡 月下 舟 。 江左L 诸贤 嗟 未远 ， 感今 怀昔 使人 愁 。
兰亭L	明	袁宏道	定武石 空在 ， 兰亭L 迹 已讹 。 清流 大概 是 ， 峻岭 果然 多 。 古屋 穿 新霤 ， 苍松 瘦 老柯 。 墨池 闲 贮水 ， 犹得 放 村鹅 。
兰亭L 即事	清	爱新觉罗·弘历	向慕 山阴L 镜里 行 ， 清游 得胜 惬 平生 。 风华 自昔 称 佳地 ， 觞咏 于今 纪 盛名 。 竹重 春烟 偏 澹荡 ， 花迟 褉日 尚 敷荣 。 临池 留得 龙跳 法 ， 聚讼 千秋 不易 评 。
若耶溪L 归兴	宋	王安石	若耶溪L 上 踏 莓苔 ， 兴罢 张帆 载酒 回 。 汀草 岸花 浑 不见 ， 青山 无数 逐 人 来 。
会稽L 竹枝词	明	王翃	秋风 秋雨 正 凄凄 ， 荷花 荷叶 香 满溪 。 越女 荡舟 愁 日暮 ， 歌声 尽在 若耶L 西 。
越女 词	唐	李白	耶溪L 采莲 女 ， 见客 棹歌 回 。 笑入 荷花 去 ， 佯羞 不 出来 。 镜湖L 水 如月 ， 耶溪L 女 似雪 。 新妆 荡 新波 ， 光景 两 奇绝 。
过 耶溪L	唐	朱庆馀	春溪 缭绕 出 无穷 ， 两岸 桃花 正 好风 。 恰是 扁舟 堪入 处 ， 鸳鸯 飞起 碧流 中 。
越中L 览古	唐	李白	越王P 勾践P 破吴 归 ， 义士 还乡 尽 锦衣 。 宫女 如花 满 春殿 ， 只今 惟有 鹧鸪 飞 。
越王P 勾践P 墓	宋	柴望	秦望山L 头 自 夕阳 ， 伤心 谁 复 赋 凄凉 。 今人 不见 亡吴 事 ， 故墓 犹传 霸越 乡 。 雨打 乱花 迷 复道 ， 鸟翻 黄叶 下 宫墙 。 登临 莫向 高台 望 ， 烟树 中原 正 渺茫 。
越中L 秋怀	唐	李白	越水L 绕 碧山 ， 周回 数千 里 。 乃是 天镜L 中 ， 分明 画 相似 。 一为 沧波 客 ， 十见 红蕖 秋 。 观涛 壮 天险 ， 望海 令人 愁 。 何必 探 禹穴L ， 逝将 归 蓬丘 。 不然 五湖L 上 ， 亦可 乘 扁舟 。
子夜 夏歌	唐	李白	镜湖L 三百 里 ， 菡萏 发 荷花 。 五月 西施P 采 ， 人看 隘 若耶L 。 回舟 不待 月 ， 归去 越王P 家 。
采莲 曲	唐	贺知章	稽山L 云雾 郁 嵯峨 ， 镜水 无风 也 自波 。 莫言 春度 芳菲 尽 ， 别有 中流 采 芰荷 。
游 鉴湖L	宋	秦观	画舫 珠帘 出 缭墙 ， 天风 吹到 芰荷 乡 。 水光 入座 杯盘 莹 ， 花气 侵人 笑语 香 。 翡翠 侧身 窥 渌酒 ， 蜻蜓 偷眼 避 红妆 。 葡萄 力缓 单衣 怯 ， 始信 湖中 五月 凉 。
思 故山	宋	陆游	千金 不须 买 画图 ， 听我 长歌 歌 镜湖L 。 湖山 奇丽 说 不尽 ， 且复 为子 陈 吾庐 。 柳姑 庙前 鱼 作市 ， 道士 庄畔 菱 为租 。 一弯 画桥 出 林薄 ， 两岸 红蓼 连 菰蒲 。
沈园L	宋	陆游	梦断 香消 四十 年 ， 沈园L 柳老 不 吹绵 。 此身 行作 稽山L 土 ， 犹吊 遗踪 一 泫然 。
诗 二首	宋	陆游	临近 城南 已 怕行 ， 沈家园L 里 更 伤情 。 香穿 客袖 梅花 在 ， 绿蘸 寺桥 春水 生 。
春游	宋	陆游	沈家园L 里 花 如锦 ， 半是 当年 识 放翁P 。 也信 美人 终 作土 ， 不堪 幽梦 太 匆匆 。
送 祝八P 之 江东L ， 赋得 浣纱石L	唐	李白	西施P 越溪L 女 ， 明艳 光 云海 。 未入 吴王P 宫殿 时 ， 浣纱 古石 今 犹在 。 桃李 新开 映 古查 ， 菖蒲 犹短 出 平沙 。 昔时 红粉 照 流水 ， 今日 青苔 覆 落花 。 君去 西秦L 适 东越L ， 碧山 青江 几超忽 。 若到 天涯 思 故人 ， 浣纱石L 上 窥 明月 。
西施P 咏	唐	王维	艳色 天下 重 ， 西施P 宁 久微 。 朝为 越溪L 女 ， 暮作 吴宫L 妃 。 贱日 岂 殊众 ， 贵来 方 悟稀 。 邀人 傅 脂粉 ， 不自 著 罗衣 。 君宠 益 娇态 ， 君怜 无 是非 。 当时 浣纱 伴 ， 莫得 同车 归 。 持谢 邻家 子 ， 效颦 安 可希 。
西施P	唐	李白	西施P 越溪L 女 ， 出自 苎萝山L 。 秀色 掩 今古 ， 荷花 羞 玉颜 。 浣纱 弄 碧水 ， 自与 清波 闲 。 皓齿 信 难开 ， 沉吟 碧云 间 。 勾践P 征 绝艳 ， 扬蛾 入 吴关 。 提携 馆娃宫L ， 杳渺 讵 可攀 。 一破 夫差P 国 ， 千秋 竟 不还 。
浣纱庙L	唐	鱼玄机	吴越 相谋 计策 多 ， 浣纱 神女 已 相和 。 一双 笑靥 才 回面 ， 十万 精兵 尽 倒戈 。 范蠡P 功成 身 隐遁 ， 伍胥P 谏死 国 消磨 。 只今 诸暨 长江L 畔 ， 空有 青山 号 苎萝L 。
西施P	唐	罗隐	家国 兴亡 自 有时 ， 吴人 何苦 怨 西施P 。 西施P 若解 倾 吴国 ， 越国 亡来 又是谁 。
随园老人P 登阁	清	袁枚	久闻 天一阁L 藏书 ， 英石 芸香 辟 蠹鱼 。 今日 椟存 珠 已去 ， 我来 翻撷 但 欷歔 。
久 不登 天一阁L 偶过 有感	清	全祖望	历年 二百 无 书恙 ， 天下 储藏 独 此家 。 为爱 墨香 长 绕屋 ， 祗怜 带草 未 开花 。 一瓻 追溯 风流 旧 ， 十载 重惊 霜鬓 加 。 老我 尚知 孤竹 路 ， 谁来 津逮 共 乘槎 。
登 二灵山L	宋	王安石	海上 神仙 窟 ， 分明 作 画图 。 山云 连 太白L ， 溪水 落 东湖L 。 路觉 行边 断 ， 亭从 僻处 孤 。 直教 殷处士P ， 城市 迹 全无 。
咏 东钱湖L	南宋	史浩	行李 萧萧 一担 秋 ， 浪头 始得 见 渔舟 。 晚烟 笼树 鸦 还集 ， 碧水 连天 鸥 自浮 。 十字港L 通 霞屿寺L ， 二灵山L 到 月波楼L 。 于今 幸遂 归湖 愿 ， 长忆 当年 贺监P 游 。
寒食 过 东钱湖L	元	袁士元	尽说 西湖L 足 信游 ， 东湖L 谁信 更 清幽 ， 一百五十 客舟 过 ， 七十二 溪 清水 流 。 白鸟 影边 霞屿寺L ， 翠微 深处 月波楼L ， 天然 景物 谁能 状 ， 千古 诗人 咏 不休 。
泛 东钱湖L	明	范钦	澄波 四望 空 ， 画舸 沂 冷风 。 野寺 轻鸥 外 ， 人家 细雨 中 。 菰蒲 临水 映 ， 洞壑 与天 通 。 即拟 寻真 去 ， 花源 杳 无穷 。
东湖L 十景	清	忻宇春	平吴 霸越 谢 成功 ， 退隐 湖滨 作 钓翁 。 自有 石矶L 留 胜迹 ， 此山 依旧 属 陶公P 。
寄 白头陀P	唐	白居易	近见 头陀P 伴 ， 云师 老 更慵 。 性灵 闲似 鹤 ， 颜状 古于 松 。 山里 犹 难觅 ， 人间 岂 易逢 。 仍闻 移 住处 ， 太白L 最高 峰 。
游 天童寺L	宋	王安石	山山 桑柘 绿浮 空 ， 春日 莺啼 谷口 风 。 二十 里 松 行 欲尽 ， 青山 捧出 梵王宫L 。
右题 天童山L 宿鹭亭L	宋	陆游	攀石 扪萝 到 更幽L ， 玲珑 咫尺 懒 穷搜 。 旁人 不会 当时 意 ， 为欠 门生 作 伴游 。
戏赠 育王P 虚白长老P	宋	王安石	白云 山顶 病 禅师 ， 昔日 公卿 各 赠诗 。 行尽 四方 年 八十 ， 却归 荒寺 有谁 知 。
招宝山L 望海	清	袁枚	招宝山L 头 坐 ， 茫茫 望 大洋 。 波涛 如 起立 ， 人世 定 洪荒 。 水合 天 无缝 ， 云生 岛 尽藏 。 有谁 温带 下 ， 亲手 折 扶桑 ？
梵王宫L	宋	郑清之	圆峤L 移来 东海 东 ， 梵王宫L 在 最高 峰 。 试将 法雨 周沙 界 ， 千丈岩L 头 挂 玉虹 。
游 梅福P 遗迹	明	许琰	青林 长 秀蔚 ， 苍岭L 故 行回 。 进地 犹 存汉 ， 山岑 尚 姓梅 。 抱忠 徒 海窟 ， 避世 且 云隈 。 千载 真 冰玉 ， 桐江L 有 钓台 。
宿 桐庐江L 寄 广陵L 旧游	唐	孟浩然	山暝 闻 猿愁 ， 沧江 急 夜流 。 风鸣 两岸 叶 ， 月照 一 孤舟 。 建德L 非 吾土 ， 维扬L 忆 旧游 。 还将 两行 泪 ， 遥寄 海 西头 。
富春L	唐	吴融	水送 山迎 入 富春L ， 一川 如画 晚 晴新 。 严光 万古 清风 在 ， 不敢 停桡 更 问津 。 天下 有水 亦 有山 ， 富春L 山水 非 人寰 。 长川 不是 春来 绿 ， 千峰 倒影 落 其间 。
出守 桐庐L 道中 十绝	北宋	范仲淹	沧浪 清 可爱 ， 白鸟 鉴中 飞 。 不信 有 京洛L ， 风尘 化 客衣 。
泛 富春江L	宋	陆游	双橹 摇江 叠鼓 催 ， 伯符P 故国 喜 重来 。 秋山 断处 望 渔浦 ， 晓日 升时 离 钓台 。 官路 已悲 捐 岁月 ， 客衣 仍悔 犯 风埃 。 还家 正及 鸡豚 社 ， 剩伴 邻翁 笑口 开 。
富春L 舟中	元	李桓	天下 佳 山水 ， 古今 推 富春L 。 我行 三度 至 ， 风景 数番 新 。 净碧 迎窗 入 ， 空青 拂面 匀 。 斑斓 工 点缀 ， 瘦石 自 嶙峋 。
富阳L 至 桐庐L 道中	明	王世贞	路疑 千岭 近 ， 山为 一江 分 。 夕照 高低 出 ， 滩声 远近 闻 。 薜农 过 木客 ， 椒酒 奠 桐君P 。 欲叩 幽栖 意 ， 峰峰 多 白云 。
富春L 至 严陵L 山水 甚佳 四首	清	纪昀	沿江 无数 好山 迎 ， 才出 杭州L 眼 便明 。 两岸 濛濛 空翠 合 ， 琉璃 镜 里 一帆 行 。 浓 似 春云 淡 似烟 ， 参差 绿到 大江L 边 。 斜阳 流水 推篷 坐 ， 翠色 随人 欲 上船 。 烟水 萧疏 总 画图 ， 若非 米老 定 倪迂 。 何须 更说 江山 好 ， 破屋 荒林 亦 自殊 。
过 七里濑L	宋	杨时	拂云 高雁 倚风 抟 ， 下视 平湖 万里 宽 。 搔首 扁舟 又 东去 ， 钱塘江L 上 看 波澜 。
七里泷L	清	蒋士铨	七里 严滩 绕 富春L ， 压篷 青重 乱山 横 。 桐江L 水似 离心 曲 ， 一片 风帆 万橹 声 。
古风 五十九 首	唐	李白	松柏 本 孤直 ， 难为 桃李 颜 。 昭昭 严子陵P ， 垂钓 沧波 间 。 身将 客星 隐 ， 心与 浮云 闲 。 长揖 万乘 君 ， 还归 富春山L 。
题 严陵P 钓台	唐	张继	旧隐 人 如在 ， 清风 亦 似秋 。 客星 沈 夜壑 ， 钓石 俯 春流 。 鸟向 乔枝 聚 ， 鱼依 浅濑 游 。 古来 芳饵 下 ， 谁是 不 吞钩 。
严陵滩L	唐	罗隐	中都L 九鼎 勤 英髦 ， 渔钓 牛蓑 且 遁逃 。 世祖P 升遐 夫子P 死 ， 原陵L 不及 钓台 高 。
入 雁荡山L	元	李孝光	兴国 年间 路 始开 ， 前朝 碑墨 半 苍苔 。 雁横 荡月 惊寒 到 ， 僧踏 湫云 看瀑 来 。 一岭 暂教 灵运P 识 ， 万松 都是 了翁P 栽 。 此行 曾共 秋风 约 ， 说与 山猿 不用 猜 。
寻 天台山L	唐	孟浩然	吾友 太乙子P ， 餐霞 卧 赤城L 。 欲寻 华顶 去 ， 不惮 恶溪 名 。 歇马 凭云 宿 ， 扬帆 截海 行 。 高高 翠微 里 ， 遥见 石梁 横 。
天台L 晓望	唐	李白	天台L 邻 四明L ， 华顶 高 百越 。 门标 赤城霞L ， 楼栖 沧岛 月 。 凭高 登远 览 ， 直下 见 溟渤 。 云垂 大鹏 翻 ， 波动 巨鳌 没 。 风潮 争 汹涌 ， 神怪 何 翕忽 。 观奇 迹 无倪 ， 好道 心 不歇 。 攀条 摘 朱实 ， 服药 炼 金骨 。 安得 生 羽毛 ， 千春 卧 蓬阙 ？
新山 别馆 十景	元	曹文晦	山北 山南 尽 白云 ， 云中 有水 接 天津 。 两龙 争壑 那 知夜 ， 一石 横空 不 度人 。 潭底 怒雷 生 雨雹 ， 松头 飞雾 湿 衣巾 。 昙华亭L 上 茶 初试 ， 一滴 曹溪L 恐 未真 。
寄题 天台L 国清寺L	唐	皮日休	十里 松门 国清路L ， 饭猿台L 上 菩提树 。 怪来 烟雨 落 晴天 ， 元是 海风 吹 瀑布 。
新山 别馆 十景	元	曹文晦	数点 残星 挂 绿萝 ， 看桃 行入 旧 山阿 。 洞门 花雾 红 成阵 ， 沙麓 岩 前 翠 作涡 。 天外 曙红 惊鹤 梦 ， 水边 啼鸟 和 渔歌 。 刘郎P 去后 无人 到 ， 吟倚 东风 草色 多 。
题 沈隐侯P 八咏楼L	唐	崔颢	梁日 东阳L 守 ， 为楼 望 越中L 。 绿窗 明月 在 ， 青史 古人 空 。 江静 闻 山狖 ， 川长 数 塞鸿 。 登临 白云 晚 ， 流恨 此 遗风 。
送 温处士P 归 黄山L 白鹅峰L 旧居	唐	李白	黄山L 四千 仞 ， 三十二 莲峰 。 丹崖 夹 石柱 ， 菡萏 金 芙蓉 。 伊昔 升 绝顶 ， 下窥 天目L 松 。 仙人 炼玉 处 ， 羽化 留 余踪 。
伯传 游 黄山L 归述 示 奇胜 赋答	明	申时行	松径 幽 仍 险 ， 云峰 秀 复 奇 。 荡胸 开 汗漫 ， 侧足 度 嵚崎 。 鸟道 人踪 绝 ， 狮林 佛力 持 。 兹山 超 五岳L ， 未必 向禽P 知 。
黄山L	明	袁中道	鹅雀 头边 过 ， 莲花 片上 眠 。 西瞻 湓浦L 雪 ， 东望 广陵L 烟 。 追琢 嗟 丹壁 ， 锋铓 骇 笋田 。 貌山 多 溢语 ， 此地 愧 难诠 。
游 黄山L 有感	明	汪玄锡	落落 相逢 好事 难 ， 百年 能见 几 黄山L 。 来当 天日 晴明 后 ， 望尽 烟霞 缥缈 间 。 世故 劳人 空 自老 ， 鬓毛 因病 已 成斑 。 仙岩 欲觅 浮丘子P ， 为我 殷勤 说 大还 。
游 黄山L	明	唐正	五色 瑞云 笼 药灶 ， 千秋 阴火 煮 汤泉 。 古今 题咏 盈 苔壁 ， 谁似 当年 李谪仙P 。
黄山L 怪松 歌	清	万斯备	黟山L 多 老松 ， 怪状 不 一格 。 阅世 几 沧桑 ， 空山 谁 考核 ？ 撑干 必 背厓 ， 穿根 长 在石 。 欲直 枝 却横 ， 将伸 肘 故屈 。 此翁 植久 似 通灵 ， 与人 相接 颇 有情 。 始信 峰前 手 接引 ， 天门 路 上 躬 送迎 。
登 莲花峰L 歌	清	黄元治	天地 开辟 河山 剖 ， 洪水 归墟 露 双藕 。 一 藕 栽 向 秦关L 中 ， 花开 西岳L 插 天陡 。 一 藕 开作 黄山L 花 ， 乃 冠 大江南北 万山 首 。 万山 已 拱 黄山L 巅 ， 莲花峰L 更 悬 青天 。 我 自 玉屏峰L 顶 望 ， 莲花 高出 玉屏 几百丈 。 更 自 玉屏 攀 莲花 ， 折下 涧底 又 天上 。 梯穷 始步 峰高头 ， 双眸 一纵 空 九州 。 片片 白云 如 飞练 ， 点点 青山 如 浮鸥 。 争雄 只有 天都峰L ， 两 不 相 下 能 相容 。 此外 峰余 三十四 ， 如 鸟 朝凤 鱼 从龙 。
飞来峰L	清	胡蔼芝	何处 飞来 不可踪 ， 岩阿 面面 白云 封 。 想 伊 也爱 黄山L 好 ， 来 为 黄山L 添 一峰 。
梦笔生花L	清	项黻	石骨 棱棱 气象 殊 ， 虬松 织翠 锦云 铺 。 天然 一管 生 花笔 ， 写 遍 奇峰 入 画图 。 如椽 大笔 说 词曹P ， 架得 铜龙 此 更高 。 天外 忽 飞 仙掌峭L ， 仗 他 腕力 试 苍毫 。
天都峰L	清	潘耒	黄山L 百千 峰 ， 兹 何 独 称长 ？ 梯 空 一万重 ， 拔地 九千丈 。 苍苍 百里外 ， 孤标 已 瞻仰 。 烟云 升 及 腰 ， 日月 行 在 掌 。 群山 自 言 尊 ， 对 之 失 气象 。 即之 如可亲 ， 攀 之 莫能 上 。
鲫鱼背L	清	许全治	无意 吞 舟 归 北海L ， 何心 借 水 跃 昆明L 。 游人 尽是 批鳞客P ， 竹杖 芒鞋 脊 上 行 。
炼丹台L	明	刘正学	黄帝P 烧丹 处 ， 高峰 面面 开 。 幽奇 人境 少 ， 杖 履 岭头 来 。 家国 恒 无地 ， 乾坤 尚 有 台 。 遥闻 松顶 上 ， 迟暮 一 猿哀 。
登 黄山L 炼丹峰L 寻 昔人 隐处	明	赵汸	我 游 黄山L 当 严冬 ， 雪消 日暖 无 天风 。 欲求 昔人 栖隐处 ， 发兴 况 有 高僧 同 。 因怜 李白P 升 绝顶 ， 空吟 菡萏 金芙蓉 。
十九日T 晓望 八仙 过海	清	释大涵	云行 仙 亦 行 ， 云止 仙 亦 止 。 小坐 任 超迁 ， 过 我 一万里 。 吕生P 吹笛 阴崖 暖 ， 张公P 拍板 秋风 短 。 玉女P 提篮 灵药 满 ， 游戏 人间 天 不管 。 沧洲L 同渡 神通 别 ， 脚踏 鼋鼍 波 喷雪 ， 有时 云脚 散 斜辉 ， 仙兮 仙兮 胡 为 归 。
文殊院L 观 云海 歌	清	曹贞吉	蓬莱阁L 外 海 作 山 ， 文殊院L 下 山 为 海 。 一片 白云 涌 空蒙 ， 眼底 千峰 皆 杳霭 。 只疑 浑沌 开 穷荒 ， 或有 风雷 泣 真宰 。 过眼 一洗 碧琉璃 ， 惊风 猛浪 嗟 何在 ？
登 清凉台L 看 云铺海	清	袁枚	清凉台L 高 迥 绝伦 ， 我 登 正值 山铺云 。 一疋布 将 天地 裹 ， 千条 练 许 山 灵分 。 初散 后聚 结作 片 ， 左缺 右补 团成群 。 古峰 几丛 未灭顶 ， 风行 水上 成奇文 。 谁将 铜斗 向空 熨 ， 压软 万顷 玻璃纹 。 疑是 王家 元宝 斗国富 ， 树树 绢挂 南山匀 。 又疑 裴氏 蓝田L 新开垦 ， 耕烟 种草 龙殷勤 。 王母 瑶池 砌白玉 ， 秦陵L 江海 流水 银 。 葛洪P 倾镕 丹鼎 汞 ， 羊欣P 乱书 白练 裙 。 相较 都觉 有 痕迹 ， 不如 此处 自然 一气 吹 氤氲 。 更喜 自身 立云上 ， 任他 白衣 苍狗 来纷纷 。 为我 一谢 云中君 ， 高歌 此曲 闻不闻 。
纪 汤泉L	唐	贾岛	维 泉 肇 何代 ？ 开凿 同 二仪 。 五行 分 水火 ， 厥 用 谁一之 ？ 在卦 得 既 济 ， 备象 坎 与 离 。 下有 风 轮煽 ， 上有 雷车 驰 。 霞 掀 祝融P 井 ， 日烂 扶桑池L 。 遐哉 哲人 逝 ， 此水 真 吾师 。 一濯 三 沐发 ， 六凿 还希夷 。 伐毛 返 骨髓 ， 发白 令人 黟 。 十年 走 尘土 ， 负我 汗漫期 。 再来 池上 游 ， 触热 三伏时 。 古寺 僧 寂寞 ， 但余 壁上诗 。 不见 题诗人 ， 令我 长 叹咨 ！
雪夜 听泉 歌	清	释传悟	人 夸 黄山L 峰峦 奇 ， 更有 水声 人 不知 。 怪石 古松 形 已定 ， 水声 变幻 神魂迷 。 冻云 欲雪 春冬夜 ， 竟能 万状 生 惊疑 。 侧耳 披衾 跌 坐起 ， 恍闻 天乐 声 渐迩 。 君不见 伯牙P 学琴 方 子春 ， 独得 移情 海岛 里 。
望 九华山L 赠 青阳 韦仲堪P	唐	李白	昔 在 九江L 上 ， 遥望 九华峰L 。 天河 挂 绿水 ， 秀出 九芙蓉 。 我 欲 一挥手 ， 谁人 可 相从 。 君 为 东道主 ， 于此 卧 云松 。
秀华亭L	唐	李白	遥望 九华峰L ， 诚然 是 九华 。 苍颜 耐 风雪 ， 奇态 灿 云霞 。 曜日 凝成锦 ， 凌霄 增 壁岩 。 羽化 骑 日月 ， 云行 翼鸳鸾 。
宿 无相寺L	唐	李白	头陀L 悬 万仞 ， 远眺 望 华峰L 。 聊借 金沙水L ， 洗 开 九芙蓉 。 烟岚 随流 览 ， 踏屐 走 双龙 。 明日 登高 去 ， 山僧 孰 与从 。 禅床 今 暂歇 ， 枕月 卧 青松 。 更尽 闻 鸟鸣 ， 恍来 报 晓钟 。
九华山L 歌	唐	刘禹锡	奇峰 一见 惊 魂魄 ， 意想 洪炉 始 开辟 。 疑是 九龙 夭矫 欲 攀天 ， 忽逢 霹雳 一声 化为 石 。 不然 何 至今 悠悠 万千年 ， 气势 不死 如 腾仚 。 轩皇P 封禅 登 云亭 ， 大禹P 会计 临 东溟L 。 乘樏 不来 广乐 绝 ， 独与 猨鸟 愁 青荧 。 君 不见 敬亭L 之山 广索漠 ， 兀如 断岸 无棱角 。 宣城L 谢守P 一首诗 ， 遂使 声名 齐 五岳L 。 九华山L ， 九华山L ， 自是 造化 一 尤物 ， 焉能 藉甚 乎 人间 ！
游 九华山L 题 天台L 高处	宋	宗杲	踏遍 天台L 不作声 ， 清钟 一杵 万山鸣 。 五钗松 拥 仙坛盖 ， 九朵 莲开 佛国城L 。 南戒L 俯瞰 江影白 ， 东岩L 坐待 夕阳明 。 名山 笑我 生天晚 ， 一首 唐诗 早 擅名 。
过 池州L 见 九华L 有感	南宋	文天祥	五老L 湖光 远 ， 九华L 山色 昏 。 南冠 前 进士 ， 北部 故将军P 。 芳草 江头路 ， 斜阳 郭外村 。 匆匆 十年梦 ， 故国 黯销魂 。
九华山L 天台峰L 新晴 晓望	南宋	吴潜	一莲峰L 簇 万花 红 ， 百里 春阴 涤 晓风 。 九十莲华 一齐 笑 ， 天台 人立 宝光 中 。
望 九华L	南宋	王十朋	九芙蓉 自 九天 来 ， 太史P 南游 山 未开 。 仙境 曾经 谪仙眼 ， 佳名 绝句 两崔嵬 。 九华山L 下 化城寺 ， 太白P 书堂 高处在 。 想见 江山 无此境 ， 故宜 头白 懒归来 。
太白祠L	明	王守仁	谪仙P 栖隐地 ， 千载 尚 高风 。 云散 九峰 雨 ， 岩飞 百丈虹 。 寺僧 传旧事 ， 词客 吊遗踪 。 回首 苍茫外 ， 青山 感慨中 。
游 九华山L	明	胡缵宗	只闻 三岛L 人间 稀 ， 不见 九华L 天下 奇 。 江边 一幅 王维P 画 ， 石上 千年 李白P 诗 。
九华L 忆 李白P	清	赵国麟	九华L 之峰 似 青莲 ， 九华L 之号 本 谪仙 。 谪仙P 亦有 青莲P 号 ， 山耶 人耶 可并传 。 谪仙 原是 太白精 ， 九华 芙蓉 造化英 。 青莲P 解咏 芙蓉句 ， 天生 李白P 山成名 。
江上 望 皖公山L	唐	李白	奇峰 出 奇云 ， 秀木 含 秀气 。 清晏 皖公山L ， 巉绝 称 人意 。 独游 沧江 上 ， 终日 淡无味 。 但爱 兹岭 高 ， 何由 过 灵异 。
题 天柱山L	唐	白居易	大徽 星斗 拱 瑶台 ， 圣祖P 灵宫 镇九垓 。 天柱L 一峰 擎 日月 ， 洞门 千仞 锁 云雷 。 玉光 白橘 香 争秀 ， 金翠 佳莲 蕊斗 开 。 时访 左慈P 高隐 处 ， 紫清 仙鹤 认巢 来 。
登 天柱山L	宋	李庚	巍然 天柱峰L ， 峻拔 插 天表 。 登跻 犹 未半 ， 身 已在 蓬岛L 。 凭虚 鸾鹤 随 ， 举步 烟云 绕 。 天下 有 奇观 ， 争似 此山 好 ！
莲字崖L	宋	苏轼	先生P 仙去 几经年 ， 流水 青山 不改迁 。 拂拭 悬崖 观 古字 ， 尘心 病眼 两 醒然 。
潜山L 古风	明	罗庄	淮南 胜地 称 舒州L ， 人烟 浩渺 林木 稠 。 山奇 水秀 足 灵秘 ， 古云 十景 何 清幽 。 嵯峨 天柱 起 天杪 ， 俯视 群峰 绝低小 。 悠悠 深涧 出 前山 ， 一色 瑶光 净 如洗 。 天生 好境 在 人世 ， 阆苑蓬莱L 奚 足贵 。 何当 结屋 傍 潜峰 ， 收拾 诗瓢 贮清气 。
天柱峰L	清	姚琅	天柱峰L 高 俯 皖山L ， 千寻 耸立 苍冥间 。 三台 森列 如 拱揖 ， 狮子L 麟角L 相 回环 。 当年 汉帝P 钦 嶙峋 ， 潜岳 封移 南岳尊 。 中有 桃花 开五色 ， 令人 不忆 武陵春 。
夜泊 牛渚L 怀古	唐	李白	牛渚L 西江L 夜 ， 青天 无 片云 。 登舟 望 秋月 ， 空忆 谢将军P 。 余 亦 能 高咏 ， 斯人 不可 闻 。 明朝 挂 帆席 ， 枫叶 落 纷纷 。
牛渚L	唐	贾岛	巨川 汇 牛渚L ， 下 有 渊灵宅 。 绝壁 俯 层岩 ， 回波 自 撞激 。 不见 燃犀人P ， 空忆 骑鲸客P 。 泊舟 陟 危亭 ， 蛾眉L 望 中 碧 。
采石L	南宋	文天祥	石上 蛾眉L 二十岁 ， 重来 为 堕 山河泪 。 今人 不见 虞允文P ， 古人 曾有 樊若水P 。 长江 阔处 平 如 驿 ， 如此 介然 衣带 窄 。 欲从 谪仙P 捉月 去 ， 安得 燃犀 照 神物 。
蛾眉亭L	元	赵孟頫	天门 日涌 大江 来 ， 牛渚 风生 万壑 哀 。 青眼 故人 携酒 共 ， 两眉 今日 为君 开 。 苍崖 直下 蛟龙 吼 ， 白浪 横空 鹅鹤 回 。 南眺 青山L 怀 李白P ， 沙头L 官渡 苦 相催 。
采石L 济 江	清	赵绍祖	云间 气绕 三山L 色 ， 树杪 波翻 六代 声 。 捉月楼L 虚仙 已去 ， 燃犀渚L 静浪 无惊 。 兴来 高唱 元晖句 ， 依旧 澄江 似 练平 。
谪仙楼L	明	端宏	谪仙L 楼阁 倚 江头 ， 一度 登临 一 系舟 。 遗像 有涯 天地 老 ， 雄才 无敌 古今 留 。 天门L 雨过 双眉L 出 ， 牛渚L 潮平 万马 收 。 倚遍 阑干 追 往事 ， 断云 残照 若 为 愁 。
太白楼L	清	姚鼐	太白楼L 头 空复空 ， 沧洲L 晴照 碧流 东 。 久 伤 白发 生 明镜 ， 每见 青山L 忆 谢公P 。 万壑 鬣松 鸣 水上 ， 九秋 霜鹘 入 云中 。 不妨 无客 闻 高咏 ， 自有 江山 兴 未穷 。
太白祠L	清	施闰章	太白P 骑鲸 去 ， 空留 采石祠L 。 当轩 千里 水 ， 绕屋 万 松枝 。 山月 正 清夜 ， 江云 无尽 时 。 谁 将 一尊 酒 ， 把臂 共论 诗 。
采石矶L 登 太白楼L	清	郭浚	蛾眉L 一簇 曲 江边 ， 楼枕 江开 别 一天 。 片石 常怀 仙磊落P ， 残樽 孤负 月婵娟 。 登临 莫惜 非 吾土 ， 景物 还应 似 昔年 。 记得 来时 山色 暝 ， 疏钟 打破 翠螺L 烟 。
望 天门山L	唐	李白	天门L 中断 楚江L 开 ， 碧水 东流 至此 回 。 两岸 青山 相 对出 ， 孤帆 一片 日边 来 。
题 东西 梁山L 三首	南宋	杨万里	二梁L 双黛 点 东西 ， 牛渚L 看来 活 底眉 。 阿敞 画时 微 失手 ， 一眉 高著 一眉 低 。 莫恨 当初 画 得 偏 ， 却因 偏 处 反 成妍 。 喜来 舒展 愁来 蹙 ， 各样 娇娆 更 可怜 。 传道 临春 昔 丽华 ， 不从 陈帝P 入 隋家 。 独将 亡国 千年 恨 ， 留下 双颦 寄 岸花 。
横江L 词	唐	李白	人道 横江L 好 ， 侬道 横江L 恶 。 一风 三日 吹 倒 山 ， 白浪 高过 瓦官阁L 。
横江L 词	唐	李白	海潮 南去 过 寻阳L ， 牛渚L 由来 险马 当 。 横江 欲渡 风波 恶 ， 一水 牵愁 万里 长 。
横江L 词	唐	李白	横江L 西望 阻 西秦L ， 汉水L 东连 扬子津L 。 白浪 如山 那 可渡 ， 狂风 愁杀 峭帆人 。
横江L 词	唐	李白	海神 来过 恶风 回 ， 浪 打 天门L 石壁 开 。 浙江L 八月 何 如此 ， 涛似 连山 喷雪 来 。
望夫石L	唐	李白	髣髴 古 容仪 ， 含愁 带 曙辉 。 露如 今日 泪 ， 苔似 昔年 衣 。 有恨 同 湘女P ， 无言 类 楚妃P 。 寂然 芳霭 内 ， 犹若 待夫 归 。
过 采石L 怀 李白P	明	宗臣	楚水 秋风 薜荔 高 ， 千帆 明月 大江 涛 。 蛾眉亭L 下 芙蓉 色 ， 犹似 当年 宫锦袍 。 夜夜 银河 倒 不流 ， 长虹 西挂 彩云 愁 。 醉来 江底 抱 明月 ， 惊落 天心 万片 秋 。
独 坐 敬亭山L	唐	李白	众鸟 高飞 尽 ， 孤云 独去 闲 。 相看 两 不厌 ， 只有 敬亭山L 。
秋 登 宣城L 谢脁北楼L	唐	李白	江城 如 画里 ， 山晚 望 晴空 。 两水 夹 明镜 ， 双桥 落 彩虹 。 人烟 寒 橘柚 ， 秋色 老 梧桐 。 谁念 北楼L 上 ， 临风 怀 谢公P 。
谢公亭L	唐	李白	谢亭L 离别 处 ， 风景 每 生愁 。 客散 青天 月 ， 山空 碧水 流 。 池花 春 映日 ， 窗竹 夜 鸣秋 。 今古 一 相接 ， 长歌 怀 旧游 。
宣城L 见 杜鹃花	唐	李白	蜀国L 曾闻 子规鸟 ， 宣城L 还见 杜鹃花 。 一叫 一回 肠一断 ， 三春 三月 忆三巴 。
怀 宛陵L 旧游	唐	陆龟蒙	陵阳L 佳地 昔年 游 ， 谢脁P 青山 李白楼L 。 惟有 日斜 溪上 思 ， 酒旗 风影 落 春流 。
游 敬亭山L	明	李东阳	敬亭L 山色 古城 阴 ， 万丈 丹梯 不易 寻 。 地重 谪仙P 题后 价 ， 天留 谢脁P 赏时 心 。 山川 代有 精灵 在 ， 草木 春回 雨露 深 。
经 谢公P 青山 吊 李翰林P	唐	杜荀鹤	何谓 先生 死 ， 先生 道 日新 。 青山 明月 夜 ， 千古 一 诗人 。 天地 空 锁骨 ， 声名 不 傍身 。 谁移 耒阳冢L ， 来此 作 吟邻 。
吊 李翰林P 墓	宋	陆游	饮似 长鲸 快 吸川 ， 思如 渴骥 勇 奔泉 。 客 从 县令 初 何有 ， 醉忤 将军P 亦 偶然 。 骏马 名姬 如 昨日 ， 断碑 乔木 不知年 。 浮生 今古 同 归此 ， 回首 桓公P 亦 故阡 。
李翰林墓L	宋	宋无	嗜酒 傲 明时 ， 何因 贺监P 知 。 承恩 金马诏 ， 失意 玉环词 。 名与 三闾 并 ， 身将 四皓P 期 。 乾坤 沉 秀气 ， 江水 带 哀声 。
经 李谪仙墓L	宋	高翥	萧萧 高冢 倚 云根 ， 父老 相传 太白坟L 。 白骨 定随 风月冷 ， 青山 常共 姓名 存 。
琅琊山L	北宋	王禹偁	连袤 复 岧峣 ， 峰峦 架 泬寥 。 流名 自 东晋T ， 积翠 满 南谯L 。 古台 临海 日 ， 绝顶 见 江潮 。 庙碑 传 汉祖P ， 寺额 认 唐朝T 。
九月廿日T 重游 琅琊山L	明	文征明	得闲 不到 山中 乐 ， 应枉 天公 与 清福 。 到滁 不到 琅琊山L ， 归去 何凭 作 公牍 。 我于 此地 虽 屡游 ， 绝境 十难 穷 五六 。 由来 在意 不在 景 ， 况 我 为山 非 为本 。 游山 无穷 如 读书 ， 愈索 愈奇 何 虑熟 。 当年 感慨 此题 诗 ， 回首 狂言 犹在 腹 。 醉翁L 不是 旧时 亭 ， 帝迹 流为 梵王 屋 。 惟余 石上 文 千首 ， 一半 崩磨 不能 读 。
东壁楼L 望 西南 诸峰	清	贺方	岭横 天际 明于黛 ， 塔隐 烟中 矗 似桅 。 出谷 碧云 舒 复敛 ， 拂林 白鸟 去仍回 。 琅琊L 深秀 堪 神往 ， 作赋 愧非 永 叔才 。
游 醉翁亭L	明	王世贞	峰回 路转 亭 翼然 ， 作亭者 谁 僧 智仙P 。 后有 醉翁P 醉 流连 ， 跻攀 石磴 披 云烟 。 古往 今来 知 几年 ， 醉翁P 耿耿 名姓传 。 一从 文字 勒 石坚 ， 至今 草木 争 光妍 。 寥寥 千载 如 逝川 ， 谁与 醉翁P 相后先 。
游 醉翁亭L	清	铁保	滁山L 万笏 青 ， 选胜 得 幽邃 。 中 有 欧阳亭L ， 翼然 卧 空 翠 。 枯梅 挺 异姿 ， 云昔 公手 植 。 老干 标 千年 ， 余蘖 发 新致 。 亭中 何所 有 ， 屡祀 富 碑记 。 屹立 坡翁 书 ， 斑驳 露 神异 。 遥遥 六一翁P ， 乐岁 勤 抚字 。 咄哉 群吏 醒 ， 何如 此 翁醉P ？
绝句	宋	李清照	生 当 作 人杰 ， 死 亦 为 鬼雄 。 至今 思 项羽P ， 不肯 过 江东 。
项王祠L	清	李锴	白蛇 断 ， 乌骓 穷 ， 海内 莫敌 隆准公P 。 百二 小儿 歌 沛中 ， 霸王P 汨没 三户空 。 眼中 成败 势 即判 ， 大王 叱咤 终 英雄 。 楚山P 沉沉 压 祠宫 ， 千秋 伏腊 犹 鼓钟 。 鼍龙 叫啸 宝剑 血 ， 草木 惨澹 云旗 风 。 乾坤 失意 丈夫 泪 ， 大江 日落 寒涛 东 。
乌江L	清	宋荦	落日 乌江L 系 小船 ， 拔山 气势 想当年 。 一间 古庙 荒烟 外 ， 野鼠 含髭 上 几筵 。
虞美人P	宋	魏夫人	鸿门L 玉斗 纷 如雪 ， 十万 降兵 夜 流血 。 咸阳L 宫殿 三月T 红 ， 霸业 已随 灰尽 灭 。 滔滔 逝水 流 今古 ， 汉楚 兴亡 两 邱土 。 当年 遗事 久 成空 ， 慷慨 尊前 为谁 舞 。
和垓下歌	秦	虞姬	汉兵 已 略地 ， 四方 楚歌声 。 大王P 意气 尽 ， 贱妾 何 聊生 。
虞姬墓L	宋	苏辙	布P 叛 增亡 国 已空 ， 摧残 羽翮 自今 穷 。 艰难 独与 虞姬P 共 ， 谁使 西来 敌 沛公P 。
虞姬墓L	宋	苏轼	帐中 佳人P 拭 泪痕 ， 门前 壮士 气 如云 。 仓黄 不负 君王 意 ， 只有 虞姬P 与 郑君P 。
题 乌江亭L	唐	杜牧	胜败 兵家 事 不期 ， 包羞 忍耻 是 男儿 。 江东L 子弟 多 才俊 ， 卷土 重来 未可知 。
乌江亭L	北宋	王安石	百战 疲劳 壮士 哀 ， 中原L 一败 势 难回 。 江东 子弟 今 虽在 ， 肯与 君王P 卷土 来 ？
李思训P 画 长江L 绝岛 图	宋	苏轼	山 苍苍 ， 水 茫茫 ， 大孤 小孤 江 中央 。 崖崩 路绝 猿鸟 去 ， 惟有 乔木 参天 长 。 客舟 何处 来 ？ 棹歌 中流 声 抑扬 。 沙平 风软 望 不到 ， 孤山 久与 船 低昂 。 峨峨 两烟 鬟 ， 晓镜 开 新妆 。 舟中 贾客 莫 漫狂 ， “ 小姑L ” 前年 嫁 “ 彭郎L ” 。
小孤山L	南宋	谢枋得	人言 此是 海门关L ， 海眼 无涯 骇 众观 。 天地 偶然 留 砥柱 ， 江山 有此 障 狂澜 。 坚如 猛士 敌 场立 ， 危似 孤臣 末世 难 。 明日 登峰 须 造极 ， 渺观 宇宙 我 心宽 。
赠 汪伦P	唐	李白	李白P 乘舟 将 欲行 ， 忽闻 岸上 踏 歌声 。 桃花 潭水 深 千尺 ， 不及 汪伦P 送 我 情 。
桃花潭L	宋	徐畴	红英 狼藉 拂 渔舟 ， 仙客P 当年 此地 游 。 今日 踏歌人P 不见 ， 碧波 无语 自 东流 。
题 翟村L 桃潭 图	清	赵青藜	桃花潭L 水深 千尺 ， 潭上人 争 羡 李白P 。 于今 潭水 依然 深 ， 无复 当年 乘舟 客 。
与 南陵L 常赞府P 游 五松山L	唐	李白	我来 五松L 下 ， 置酒 穷 跻攀 。 征古 绝遗 老 ， 因名 五松山L 。 五松L 何 清幽 ， 胜境 美 沃洲L 。 萧飒 鸣 洞壑 ， 终年 风雨 秋 。
答 杜秀才P 五松山L 见赠	唐	李白	爱听 松风 且 高卧 ， 飕飕 吹尽 炎氛 过 。 登崖 独立 望 九州L ， 阳春 欲奏 谁 相和 。
游 五松山L 观 李太白祠堂L	宋	李纲	大江 东南 流 ， 鼓舵 江水 上 。 薄游 五松山L ， 获见 谪仙P 像 。 作诗 几千 篇 ， 醉笔 笼 万象 。 迄今 有 遗祠 ， 识者 共 瞻仰 。
游 太白书堂L	明	戴昺	舣舟 来访 宝云寺L ， 快上 山头 寻 五松 。 捉月仙人P 呼 不醒 ， 一间 老屋 战 西风 。
题 陈公园L	宋	苏轼	落帆 重到 古铜山L ， 长是 江风 阻 往还 。 要使 谪仙P 回 舞袖 ， 千年 翠拂 五松山L 。
发 铜陵L	清	刘大櫆	大江 风急 峭帆 喧 ， 帆影 江声 万马 奔 。 朝发 铜陵L 未 朝饭 ， 雨山 如画 过 天门L 。
过 铜陵L	清	方城	铜鼓山L 头 夕照 低 ， 铜官城L 外 草 萋萋 。 东风 慰藉 羁 人意 ， 几日 归帆 尽 向西 。
秋浦L 歌	唐	李白	水 如 一匹 练 ， 此地 即 平天L 。 耐可 乘 明月 ， 看花 上 酒船 。
秋浦L 歌	唐	李白	秋浦L 千重 岭 ， 水车岭L 最奇 。 天倾 欲 堕石 ， 水拂 寄 生枝 。
秋浦L 歌	唐	李白	江祖L 一片 石 ， 青天 扫 画屏L 。 题诗 留 万古 ， 绿字 锦 苔生 。
秋浦L 歌	唐	李白	秋浦L 长似 秋 ， 萧条 使人 愁 。 遥传 一掬 泪 ， 为我 达 扬州L 。
秋浦L 歌	唐	李白	秋浦L 猿 夜愁 ， 黄山L 堪 白头 。 何年 是 归日 ， 雨泪 下 孤舟 。
清明T	唐	杜牧	清明时节T 雨 纷纷 ， 路上 行人 欲 断魂 。 借问 酒家 何处有 ， 牧童P 遥指 杏花村L 。
杏花村L	清	苏应穟	池阳L 二月T 春气 深 ， 春江L 水溢 春波 兴 。 遥岑 曲曲 青帘 下 ， 明湖L 翠冷 远山亭 。 谁家 铁笛 暗 飞声 ， 芳草 天涯 无限 情 。 醉来 欲傍 黄公P 住 ， 不记 当年 放歌 处 。 笑指 当年 杨柳 边 ， 又向 前村 踏花 去 。
九日T 齐山L 登高	唐	杜牧	江涵 秋影 雁 初飞 ， 与客 携壶 上 翠微L 。 尘世 难逢 开口 笑 ， 菊花 须插 满头 归 。 但将 酩酊 酬 佳节T ， 不用 登临 叹 落辉 。 古往 今来 只 如此 ， 牛山L 何必 泪 沾衣 。
夜 宿 山寺L	唐	李白	危楼L 高 百尺 ， 手 可 摘 星辰 。 不敢 高声 语 ， 恐惊 天上 人 。
宿 池州L 齐山寺L ， 即 杜牧P 之 九日T 登高处	宋	杨万里	我来 秋浦 正 逢秋 ， 梦里 重来 似 旧游 。 风月 不供 诗酒债 ， 江山 长管 古今 愁 。 谪仙P 狂饮 颠 吟寺 ， 小杜P 倡情 冶 思楼L 。 问着 州民 浑不识 ， 齐山L 依旧 俯 寒流 。
咏 齐山L	清	姜龙彪	山离 城南 二三里 ， 景胜 西湖L 六七分 。 彼似 人工 加 点缀 ， 此因 天趣 绝 尘氛 。 无岩 不是 玲珑体 ， 有石 皆成 皴瘦纹 。 最爱 翠微亭L 上 望 ， 岚光 连 水 水 连 云 。
登 中都L 鼓楼L 诗	清	张宣	飞甍 画栋 连空起 ， 濠梁L 城外 月 如水 。 踏春 人踞 最高巅 ， 灯光 散落 千门里 。
皇陵L	明	何景明	陵阁L 皇灵 閟 ， 山河 王气 遥 。 万年 龙虎袍 ， 今夜 鬼神 朝 。 玉碗 留 天地 ， 金灯 照 寂寥 。 如看 翠华度 ， 缥缈 在 青霄 。
旧陵L	清	项樟	旧陵L 南郭L 外 ， 一径 短 垣中 。 雷雨天 成幻 ， 风沙 夜 聚空 。 荒碑 欹 蔓草 ， 石马 卧 幽宫L 。 极目 平原 上 ， 残阳 几树 红 。
示 家人	清	张英	一纸 书来 只为 墙 ， 让他 三尺 又 何妨 。 长城L 万里 今 犹在 ， 不见 当年 秦始皇P 。
游 武夷L	宋	陆游	少读 封禅书 ， 始知 武夷L 君 。 晚乃 游 此山 ， 秀杰 非 昔闻 。 三十六 奇峰 ， 秋晴 无 纤云 。 溯流 进 小艇 ， 愧惊 白鸥 群 。
武夷山L	元	萨都剌	三十六峰 飞 翠寒 ， 手携 玉杖 叩 元关 。 神仙 曾到 有 遗迹 ， 天地 已来 无 此山 。 木杪 楼台 浮 海上 ， 月中 笙乐 奏 云间 。 天宫 借得 宁王P 笛 ， 骑取 萧郎P 赤凤 还 。
武夷L	宋	谢章	武夷L 甲 天下 ， 清绝 多 奇趣 。 名峰 三十六 ， 一一 拱 天柱 。 此境 非 人寰 ， 蔚为 神仙 所 。 我欲 探 穷源 ， 白鸥 没 星渚L 。
武夷L 三十六峰 歌	清	何瀚	大王L 屹立 如 砥柱 ， 寒碧 玉笥 留 题古 。 玉女L 亭亭 二 侍随 ， 疑为 西幄 右 仙侣 。 马鞍L 簇簇 御 云车 ， 秦时T 毛女 曾 结庐 。 全山 百二十 里 中 ， 巍然 乃是 天心峰L 。
武夷山L	宋	辛弃疾	玉女峰L 前 一 棹歌 ， 烟鬟 雾髻 动 清波 。 游人 去后 枫林夜 ， 月满 空山 可 奈何 。
题诗岩L	唐	许碏	阆苑L 花前 是 醉乡 ， 踏翻 王母 九霞 觞 。 群仙 拍手 嫌 轻薄 ， 谪向 人间 作酒 狂 。
在 舟中 回望 天游L 一览 已在 天上	清	袁枚	一楼L 高立 万峰巅 ， 远望 迢迢 在 半天 。 昨日 幸侬 楼上 住 ， 不然 还道 住 神仙 。
游 武夷L	北宋	李纲	一溪 贯 群山 ， 清浅 萦 九曲L 。 溪边 列 岩岫 ， 倒影 浸 寒绿 。
武夷L 歌	宋	王埜	十六 洞天 天下 奇 ， 三十六峰 名 武夷L 。 武夷山L 中 溪九曲L ， 曲曲 泻出 清涟漪 。
九曲L 棹 歌	宋	朱熹	武夷山L 上 有 仙灵 ， 山下 寒流 曲曲 清 。 欲识 个 中 奇绝 处 ， 棹歌 闲听 两三 声 。 一曲 溪边 上 钓船 ， 幔亭峰L 影蘸 晴川 。 虹桥L 一断 无消息 ， 万壑 千岩 锁翠烟 。
泛舟	宋	詹师文	九曲L 烟霞 景 若何 ？ 移舟 曲曲 泛 清波 。 丹峰 绝顶 笼 花木 ， 碧洞 当门 挂 薜萝 。 仙径 鹤翻 松露 下 ， 古潭 龙蛰 水云 多 。 紫阳P 去后 闲 风月 ， 独向 平林 倚 棹歌 。
游 武夷L	明	龚一清	武夷L 之奇 奇以曲 ， 武夷L 之曲 可 方舟 。 水声 潺湲 经 壑底 ， 一碧 流成 九折 秋 。 坐看 峰头 云 掩映 ， 蓬莱L 五色 连 瀛洲L 。 嗟乎 封禅 七十二 ， 秦皇P 汉帝P 海外 求 。
闽江L 怀古	清	梁瑞芝	全闽 江山 称 第一 ， 中有 危台 突然 出 。 江水 吞天 风 逐云 ， 无数 蛟虬 翻 浪溢 。 当年 降汉 疏 封王 ， 襟吴 带越 开 雄疆 。 一自 苍江L 跨龙 去 ， 精灵 剑槊 江 中央 。
闽城L 岁暮	元	萨都剌	岭南L 春早 不见 雪 ， 腊月T 街头 叫卖 花 。 海国 人家 除夕T 近 ， 满城 微雨 湿山 茶 。
水调歌头 · 三山L 用 赵丞相P 韵	宋	辛弃疾	说与 西湖L 客 ， 观山 更 观水 ， 淡妆 浓抹 西子 ， 唤起 一时 观 。 种柳 人 今 天上 ， 对酒歌 翻水调 ， 醉墨 春秋澜 。 老子 兴 不浅 ， 歌舞 莫教 闲 。 看尊 前 ， 轻 聚散 ， 少 悲欢 。 城头 无限 今古 ， 落日 晓 霜寒 。 谁教 黄鸡 白酒 ， 犹记 红旗 清夜 ， 千骑 月临关 。 莫说 西州L 路 ， 且尽 一杯 看 。
贺 新郎 · 三山L 雨中 游 西湖L ， 有怀 赵丞相P	宋	辛弃疾	翠浪 吞 平野 。 挽 天河 ， 谁来 照影 ， 卧龙山L 下 。 烟雨 偏宜 晴 更好 ， 约略 西施P 未嫁 。 待 细把 ， 江山 图画 。 千顷 光中 堆 滟滪 ， 似 扁舟 欲下 瞿塘马 。 中有 句 ， 浩难 写 。 诗人 例入 西湖P 社 。 记 风流 ， 重来 手种 ， 绿 成阴 也 。 陌上 游人 夸 故国 ， 十里 水晶台榭L 。 更复 道横 空清夜 。 粉黛 中洲 歌 妙曲 ， 问 当年 鱼鸟 无 存者 。 堂上 燕 ， 又 长夏 。
厦门L 题壁	明	施德政	偏师 春尽 渡 澎湖L ， 圣主P 初分 海外 符 。 鼙鼓 数声 雷 乍发 ， 舳舻 百尺 浪 平铺 。 争传 日下 妖 氛恶 ， 那管 大边 逆旅 孤 。 为道 凯歌 宜 早唱 ， 江南 五月T 有 莼鲈 。
饮酒	东晋	陶渊明	结庐 在 人境 ， 而无 车马 喧 。 问君 何 能尔 ， 心远 地 自偏 。 采菊 东篱 下 ， 悠然 见 南山L 。 山气 日 夕佳 ， 飞鸟 相 与还 。 此中 有 真意 ， 欲辨 已 忘言 。
湖口L 望 庐山L 瀑布 水	唐	张九龄	万丈 红泉 落 ， 迢迢 半 紫氛 。 奔流 下 杂树 ， 洒落 出 重云 。 日照 虹霓 似 ， 天清 风雨 闻 。 灵山L 多 秀色 ， 空水 共 氤氲 。
晚泊 浔阳L 望 香炉峰L	唐	孟浩然	挂席 几千里 ， 名山 都 未逢 。 泊舟 浔阳郭L ， 始见 香炉峰L 。 尝读 远公P 传 ， 永怀 尘外踪 。 东林 精舍 近 ， 日暮 但 闻钟 。
庐山L 谣 寄 庐侍 御 虚舟	唐	李白	我 本 楚狂人P ， 凤歌 笑 孔丘P 。 手持 绿 玉杖 ， 朝别 黄鹤楼L 。 五岳L 寻仙 不辞 远 ， 一生 好入 名山 游 。 庐山L 秀出 南斗 旁 ， 屏风 九叠 云锦 张 。 金阙 前开 二峰帐 ， 银河 倒挂 三石梁 。 登高 壮观 天地 间 ， 大江 茫茫 去不还 。 黄云 万里 动 风色 ， 白波 九道 流雪山 。 好为 庐山L 谣 ， 兴 因 庐山L 发 。
望 庐山L 瀑布	唐	李白	日照 香炉L 生 紫烟 ， 遥看 瀑布 挂 前川 。 飞流 直下 三千尺 ， 疑是 银河 落 九天 。
望 庐山L 瀑布	唐	李白	西登 香炉峰L ， 南见 瀑布 水 。 挂流 三百丈 ， 喷壑 数十里 。 欻如 飞电 来 ， 隐若 白虹 起 。 初惊 河汉 落 ， 半洒 云天 里 。 仰观 势 转雄 ， 壮哉 造化 功 。
望 庐山L 五老峰L	唐	李白	庐山L 东南 五老峰L ， 青天 削出 金芙蓉 。 九江 秀色 可 揽结 ， 吾将 此地 巢云松 。
别 东林寺L 僧	唐	李白	东林L 送客处 ， 月出 白猿 啼 。 笑别 庐山L 远 ， 何烦 过 虎溪L 。
赠 王判官P ， 时余 归隐 ， 居 屏风叠L	唐	李白	昔别 黄鹤楼L ， 蹉跎 淮海L 秋 。 俱飘 零 落叶 ， 各散 洞庭 流 。 大盗 割 鸿沟 ， 如风 扫 秋叶 。 吾非 济代 人 ， 且隐 屏风叠L 。
庐山L 高赠 同年 刘中允P	北宋	欧阳修	庐山L 高 哉 几千仞 兮 ， 根盘 几百里 ， 崴然 屹立 于 长江 。 长江 西来 走 其下 ， 是为 扬澜 左蠡L 兮 ， 洪涛 巨浪 日夕 相 舂撞 。 云消 风止 水镜 净 ， 泊舟 登岸 而 远望 兮 ， 上摩 青苍 以 晻霭 ， 下压 后土 之 鸿庞 。 试往 造 乎 其间 兮 ， 攀缘 石磴 窥 空谾 。 水声 聒聒 乱 人耳 ， 六月T 飞雪 洒 石矼 。 但见 丹霞 翠壁 远近 映 楼阁 ， 晨钟 暮鼓 杳 蔼罗 幡幢 。 幽花 野草 不知 其名 兮 ， 风吹 露湿 香涧谷 ， 时有 白鹤 飞来 双 。
题 西林壁L	宋	苏轼	横看 成岭 侧 成峰 ， 远近 高低 各 不同 。 不识 庐山L 真面目 ， 只缘 身在 此山 中 。
宿 东林寺L	宋	陆游	看尽 江湖 千万峰 ， 不嫌 云梦 芥 吾胸 。 戏招 西塞山L 前 月 ， 来听 东林寺L 里 钟 。 远客 岂知 今 再 到 ， 老僧 能记 昔 相逢 。 虚窗 熟睡 谁 惊觉 ， 野碓 无人 夜自 舂 。
写 庐山L 图 上	元	虞集	忆昔 系船 桑落洲L ， 洲前 五老 当 船头 。 风吹 云气 迷谷 起 ， 霜堕 枫叶 令人 愁 。 高人 只在 第九叠 ， 太白P 一去 三千秋 。 石桥 二客 如 有待 ， 裹茶 试泉 春岩 幽 。
题 醉石	明	郭波澄	渊明P 醉 此石 ， 石亦 醉 渊明P 。 千载 无人 会 ， 山高 风月 清 。 石上 醉痕 在 ， 石下 醒泉 深 。 泉石 晋 时有 ， 悠悠 知 我心 。 五柳P 今 何处 ？ 孤松 还独 青 。 若非 当醉 ， 尘梦 几人 醒 。
白鹿书院L	清	袁枚	少室山人P 旧 草庐 ， 隔朝 换作 紫阳P 居 。 一松 门外 张 华盖 ， 五老L 云中 看 读书 。 白鹿 仙踪 流水 远 ， 青衿 灯火 讲 堂虚 。 人间 何处 寻 精舍 ， 稷下L 淹中 恐 不如 。
游 白鹿洞L 歌	明	紫霞真人	何年 白鹿洞L ？ 正傍 五老峰L 。 五老L 去天 不盈尺 ， 俯窥 人世 烟云 重 。 我欲 揽 秀色 ， 一一 青芙蓉 。 风雷 隐隐 万壑泻 ， 凭崖 倚树 闻 清钟 。 洞门 之外 百丈松 ， 千株 尽 化为 苍龙 。
白鹿洞L	明	李梦阳	五老峰L 前 晓 自来 ， 玉泉亭L 上 共 衔杯 。 苍松 翠壁 烟霞地 ， 复睹 延平L 后 学 开 。
滕王阁L	唐	王勃	滕王高阁L 临 江渚 ， 佩玉 鸣鸾 罢 歌舞 。 画栋 朝飞 南浦L 云 ， 珠帘 暮卷 西山L 雨 。 闲云 潭影 日 悠悠 ， 物换 星移 几度 秋 。 阁中 帝子P 今 何在 ？ 槛外 长江L 空 自流 。
江行 杂诗	唐	钱起	幽怀 念 烟水 ， 长恨 隔 龙沙L 。 今日 滕王阁L ， 分明 见 落霞 。
重登 滕王阁L	唐	李涉	滕王阁L 上 唱 伊州 ， 二十 年前 向 此 游 。 半是 半非 君 莫问 ， 西山L 长在 水 长流 。
题 滕王阁L	宋	夏竦	面临 江水 势 凌霞 ， 却倚 重城L 十万 家 。 当槛 晓云 依 鹤岭 ， 拂阶 残雨 下 龙沙 。 词人 乐石 文 皆在 ， 帝子 欢游 事 未赊 。 好是 良宵 金鼓 动 ， 阑干 牛斗 逼 檐斜 。
滕王阁L	北宋	王安石	白浪 翻江 无 已时 ， 陈蕃P 徐孺 去 何之 ？ 愁来 径上 滕王阁L ， 覆取 文公P 一片 碑 。
滕王阁L 感怀	北宋	王安国	滕王P 平日 好 追游 ， 高阁 依然 枕 碧流 。 胜地 几经 兴 废事 ， 夕阳 偏照 古今 愁 。 城中 树密 千家市 ， 天际 人归 一叶舟 。 极目 烟波 吟 不尽 ， 西山L 重迭 乱云 浮 。
滕王阁L 二首	南宋	徐俯	一日 因 王 造 ， 千年 与 客 游 。 云边 梅岭L 出 ， 坐下 赣江L 流 。 云气 浮 高栋L ， 波澜 绕 古城L 。 故王P 歌舞 地 ， 帆急 见 山行 。
滕王阁L	宋	宗必经	高阁 连城 十二栏 ， 西风 领客 共 跻攀 。 半帘 烟雨 长江 外 ， 千里 湖山 咫尺 间 。 雁带 秋声 归 别浦 ， 莺分 春色 过 巴山 。 当年 蛱蝶 知 谁画 ， 一梦 庄周P 去 不还 。
忆 滕王阁L	清	尚镕	天下 好 山水 ， 必有 楼台 收 。 山水 与 楼台 ， 又须 文字 留 。 黄鹤L 盘 鄂渚 ， 岳阳L 据 巴丘L 。 吾乡 滕王阁L ， 鼎足 成 千秋 。
泛 宫亭湖L	南北朝	刘删	回舻 乘 派水 ， 举帆 逐 分风 。 滉漾 疑 无际 ， 飘飏 似 度空 。 樯乌 排 鸟 路 ， 船影 没 河宫 。 孤石 沧波 里 ， 匡山L 苦 雾中 。 寄谢 千金子 ， 安知 万里 蓬 ！
彭蠡L 湖口 望 庐山L	唐	孟浩然	太虚 生 月晕 ， 舟子 知 天风 。 挂席 候 明发 ， 渺漫 平湖L 中 。 中流 见 匡阜L ， 势压 九江 雄 。 香炉L 初上 日 ， 瀑布 喷 成 虹 。 久欲 追 尚子P ， 况兹 怀 远公P 。 寄言 岩栖 者 ， 毕趣 当来 同 。
泛 彭蠡L 寄 黄判官P	唐	李白	浪动 灌婴井L ， 浔阳江L 上 风 。 开帆 入 天镜 ， 直向 彭湖L 东 。
望湖亭L	北宋	苏轼	八月T 渡 长湖L ， 萧条 万象 疏 。 秋风 片帆 急 ， 暮霭 一山 孤 。 许国 心 犹在 ， 康时 术 已虚 。 岷L 峨L 家 万里 ， 投老 得 归无 ？
上 观音阁L	北宋	苏轼	岩上 观音L 岩下 湖 ， 俨如 南海L 旧 规模 。 庭前 翠竹 千竿 有 ， 门外 红尘 半点 无 。 水绕 三山 同 楚地 ， 势连 五老L 共 洪都 。 夜来 一片 无私 月 ， 照见 摩尼 顶上 珠 。
登 石钟L 观音阁L	明	高旭	胜景 无如 此处幽 ， 经过 不厌 又 追游 。 岩栖 远望 疑 悬壁 ， 阁道 攀援 即 舣舟 。 庐阜L 群峰 朝暮 见 ， 鄱湖L 一水 古今 流 。 登临 顿觉 襟怀 阔 ， 消尽 人间 万斛 忧 。
石钟山L	清	王士祯	苏公 游赏 后 ， 余韵 石钟山 。 水石 长 如此 ， 行人 自 不闲 。 鹤巢 丹壁 上 ， 鱼罱 翠微 间 。 安得 乘 明月 ， 扁舟 数 往还 。
石钟山L 怀 苏公P	清	崔峤	山 环 彭蠡L 寺 环 松 ， 飞岛 悬崖 数十 重 。 一自 坡仙 寻 绝壁 ， 几曾 游客 破 苔封 ？ 新岚 映水 浮 秋碧 ， 怪石 冲波 响 夜钟 。 访古 独来 追 胜事 ， 怀苏亭L 在 翠微峰L 。
石钟山L	清	吴法韶	频流 合注 两峰L 横 ， 乱石 危矶 势 欲 倾 。 绿树 经年 迷 谷口 ， 翠微L 尽日 满 江城L 。 吴天 烟雨 三春 尽 ， 楚天 风涛 半夜 生 。 一自 髯苏 留记 后 ， 好山 不说 说 钟声 。
石钟山L	清	熊光	坡老 去 千古 ， 我来 追昔 游 。 钟声 长 在水 ， 石气 最 宜秋 。 列嶂 包 城远 ， 飞萝 袅 寺浮 。 欲看 彭蠡L 色 ， 一半 划 江流 。
豫章行	隋	薛道衡	江南 地远 接 闽瓯L ， 山东L 英妙 屡 经游 。 前瞻 迭嶂 千重阻 ， 却带 惊湍 万里 流 。 枫叶 朝飞 向 京洛L ， 文鱼 夜过 历 吴洲L 。
登 城楼 望 西山L 作	唐	张九龄	城楼 枕 南浦L ， 日夕 顾 西山L 。 宛宛 鸾鹤 处 ， 高高 烟雾 间 。 仙井 今 犹在 ， 洪崖 久 不还 。 檐标 千峰 出 ， 云中 一鸟 闲 。
临章 亭	唐	崔国辅	杨柳 映 春江L ， 江南 转 佳丽 。 吴门 绿波 里 ， 越国 青山 际 。 云留 西北客 ， 气歇 东南帝P 。 独有 凄凄 心 ， 谁知 怨 芳岁 。
南昌L 晚眺	唐	韦庄	南昌L 城郭 枕 江烟 ， 章水 悠悠 浪 拍天 。 芳草 绿遮 仙尉 宅 ， 落霞 红衬 贾人船 。 霏霏 阁上 千山 雨 ， 嘒嘒 云中 万树 蝉 。 怪得 地多 章句 客 ， 庾家楼L 在 斗牛 边 。
寄题 程公 辟 物华楼	北宋	王安石	千里 名城L 楚 上 游 ， 江山 多在 物华楼L 。 偶陪 南望 重重 绿 ， 章水 还能 向 北流 。
徐孺子墓L	明	杨廉	荒墙L 几里 去 城闉 ， 宿草 离离 秋 复 春 。 试数 东都L 多 节士 ， 不污 钩党 独 斯人 。 废兴 可 便 能 忘国 ， 明哲 从来 是 保身 。 莫笑 黄堂L 劳 一榻 ， 青编 千古 话 徐陈P 。
徐孺子亭L 马 上 口号	唐	权德舆	湖上 荒亭L 临水 开 ， 龟文 篆字 积 莓苔 。 曲江L 北海L 今 何处 ？ 尽逐 东流 去 不回 。
南浦L 别	唐	白居易	南浦L 凄凄 别 ， 西风 嫋嫋 秋 。 一看 肠 一断 ， 好去 莫 回头 。
南浦亭L	南宋	文天祥	半生 几度 此 登临 ， 流落 如今 雪 满簪 。 南浦L 不知 春色 晚 ， 西山L 但觉 日 初阴 。 谁怜 龟鹤 千年 语 ？ 空负 鹏鸥 万里 心 ！ 无限 故人 檐雨 外 ， 夜深 如有 广陵L 春 。
西江L 绝笔	明	娄妃	画虎 屠龙 叹 旧图 ， 血书 才了 凤 睛枯 。 迄今 十丈 鄱阳水L ， 流尽 当年 泪点 无 。
湓城L	南朝	张正见	匡山L 暧 远壑 ， 灌垒L 属 中流 。 城花 飞 照水 ， 江月 上 明楼 。
题 浔阳楼L	唐	白居易	常爱 陶彭泽P ， 文思 何 高玄 ！ 又怪 韦江州P ， 诗情 亦 清闲 。 今朝 登 此楼 ， 有以 知 其然 。 大江 寒 见底 ， 匡山L 青 倚天 。 深夜 湓浦月 ， 平旦 炉峰 烟 。 清辉 与 灵气 ， 日夕 供 文篇 。 我 无 二人 才 ， 孰 为 来 其间 ？ 因高 偶成 句 ， 俯仰 愧 江山 。
浔阳楼L	清	佟法梅	琵琶 一曲 断肠 声 ， 触拨 当筵 谪 宦情 。 为语 江州 白司马P ， 留将 眼泪 哭 苍生 。
锁江楼L	清	李尚清	楚水 沆漭 渐 入吴 ， 层楼 重影 塔峰 孤 。 凭栏 目送 时 千里 ， 不识 长江L 锁住 无 ？
大孤山L	明	陈云德	谁 削 青芙蓉 ？ 独 插 彭湖L 里 。 平分 五老L 云 ， 远挹 九江 水 。 日月 共 吞吐 ， 烟雾 互 流徙 。 大力 障 狂澜 ， 与 天地 始终 。
归 去 来 兮	东晋	陶渊明	归 去 来 兮 ， 田园 将 芜 胡 不归 ？ 归 去 来 兮 ， 请 息 交以 绝游 。 世 与 我 而 相遗 ， 复驾 言 兮 焉 求 。 富贵 非 吾 愿 ， 帝乡L 不可 期 。 怀 良辰 以 孤往 ， 或 植杖 而 耘耔 。 登 东皋 以 舒啸 ， 临 清流 而 赋诗 ， 聊 乘化 以 归尽 ， 乐夫 天命 复 奚 疑 。
赠 崔秋浦P	唐	李白	吾爱 崔秋浦P ， 宛然 陶 令 风 。 门前 五 杨柳 ， 井上 二 梧桐 。
鲁 颂	周	诗经	泰山L 岩岩 ， 鲁邦L 所 詹 。
汉武P 鼎 铭	汉	刘彻	登 于 泰山L ， 万寿 无疆 。 四海 宁谧 ， 神鼎 传芳 。
驱车 篇	东汉	曹植	神 哉 彼 泰山L ， 五岳 专 其名 。 隆高 贯 云霓 ， 嵯峨 出 太清 。 周游 二六 候 ， 间置 十二 亭 。 上有 涌 醴泉 ， 玉石 扬 华英 。
泰山L 吟	唐	李白	四月T 登 泰山L ， 石平 御道 开 。 天门 一 长啸 ， 万里 清风 来 。 玉女 四五 人 ， 飘飘 下 九垓 。 含笑 引 素手 ， 遗我 流 霞杯 。 稽首 再 拜 之 ， 自愧 非 仙才 。 旷然 小 宇宙 ， 弃世 何 悠哉 。
望 岳	唐	杜甫	岱宗L 夫 如何 ， 齐鲁L 青 未了 。 造化 钟 神秀 ， 阴阳 割 昏晓 。 荡胸 生 层云 ， 决眦 入归 鸟 。 会当 凌 绝顶 ， 一览 众山 小 。
登 泰山L	元	张养浩	风云 一举 到 天关 ， 快意 平生 有 此 观 。 万古 齐州L 烟 九点 ， 五更 沧海 日 三竿 。 向来 井处 方 知隘 ， 今后 巢居 亦 觉宽 。 笑拍 洪崖 咏 新作 ， 满空 笙鹤 下 高寒 。
登 岳	明	边贡	玉皇 祠畔 一 凭栏 ， 绝顶 风高 夏 亦 寒 。 北去 尘沙 通 瀚海 ， 西来 天地 是 长安L 。 青云 迥隔 三千 界 ， 白日 平临 十八 盘 。 似有 飞仙 度 幽壑 ， 风笙 声袅 珮 珊珊 。
登 泰山L	明	杨继盛	志欲 小 天下 ， 特来 登 泰山L 。 仰观 绝顶 上 ， 犹有 白云 还 。
登 岱	明	徐中行	东岳 峥嵘 迥 不群 ， 中峰 瑞霭 更 氤氲 。 天门L 雪尽 河流 合 ， 日观 春晴 海色 分 。 风起 秦松 常 似雨 ， 气蒸 汉柏 欲 成云 。 千秋 霸业 终 销歇 ， 犹说 相如 封 禅文 。
登 岱	清	康熙	岩岩 岱岳 高 无极 ， 攀陟 遥登 最 上头 。 路转 天门L 青霭 合 ， 峰回 日观 白云 浮 。 振衣 嶻嶭 凌 千仞 ， 骋目 苍茫 辨 九州L 。 欲与 臣邻 崇 实政 ， 金泥 玉检 不须 留 。
重登 泰山L 观 唐T 《 纪 泰山L 铭 》 碑	清	沈廷芳	我 登 泰山L 岁乙丑T ， 但 拓 摩崖碑 以归 。 夜就 摩崖碑 畔宿 ， 凌晨 独起 揽 古愁 。 缅惟 开元 全盛 日 ， 政出 仁义 被 九州 。 巨手 传自 张说笔 ， 颂扬 功德 何太劭 。 明皇P 八分 洵 迈古 ， 大书 深刻 高崖 峭 。 用肇 天宝 丧乱 基 ， 唐室 陵夷 延末 造 。
岁除日T 与 子颖L 登 日观峰L 观 日出 作歌	清	姚鼐	泰山L 到海 五百里 ， 日观L 东看 直 一指 。 万峰 海上 碧 沉沉 ， 象伏 虎蹲 呼 不起 。 夜半 云海 浮 岩空 ， 雪山 灭没 空 云中 。 参旗 正拂 天门L 西 ， 云汉 却跨 沧海 东 。 海隅 云光 一线 动 ， 山如 舞袖 招 长风 。 使君P 长髯 真 虬龙 ， 我亦 鹤骨 撑 青穹 。 天风 飘飘 拂 东向 ， 拄杖 探出 扶桑红 。 地底 金轮 几及 丈 ， 海右 天鸡 才 一唱 。 不知 万顷 冯夷宫 ， 并作 红光 上 天空 。
题 晒经石L 水帘	明	崔应麒	晒经石L 上 水帘 帛 ， 谁挽 银河 落 半天 。 新月 控钩 朝 挂玉 ， 长风 吹浪 暮 疑烟 。 梵音 溅沫 干 还湿 ， 曲涧 流云 断 复连 。 选胜 具 觞恣 幽赏 ， 题诗 愧 乏笔 如椽 。
经 石峪L 看 红叶	清	石祖芬	中天门L 外 梵仙乡 ， 枫叶 初经 九月 霜 。 独倚 高柯 舒 冷艳 ， 不侪 凡卉 炫 秋香 。 孤红 莫恨 荣华 晚 ， 众绿 都成 惨淡 光 。 休上 危桥 云步 迥 ， 更高 寒处 更 凄凉 。
游 灵岩寺L	明	薛瑄	路入 山门 景 便幽 ， 高风 不断 石林 秋 。 照人 霜叶 红 于 染 ， 拂袖 岚光 翠 欲流 。 几过 野桥 横 绝涧 ， 遥从 古刹 见 高楼 。 北峰L 真与 天 相接 ， 更拟 攀萝 到 上头 。
灵岩寺L	明	许邦才	涧壑 萦回 绕 梵宫L ， 诸天 色相 坐 来同 。 岩崖 阴积 千年 雪 ， 铃铎 宵闻 十里 风 。 寺抱 五云 金界 丽 ， 塔衔 孤月 玉 毫空 。 石僧 东岭 缘 何事 ， 似指 莲花 问 朗公P 。
五大夫 松	清	乾隆	五松 列峙 泰山L 道 ， 祖龙 经锡 大夫号 。 后世 因以 称 秦松 ， 其实 秦松 时 已老 。 异 哉 名实 谁 宾主 ， 实 以 名存 今 即古 。 何不 谓之 舜P 五臣 ， 肆觐 于 斯 同 律度 。
陪 李北海P 宴 历下亭	唐	杜甫	东藩P 驻 皂盖 ， 北渚L 凌 清河 。 海右 此亭 古 ， 济南L 名士 多 。 云山 已 发兴 ， 玉珮 仍 当歌 。 修竹 不受 暑 ， 交流 空 涌波 。 蕴真 惬 所遇 ， 落日 将 如何 。 贵贱 俱 物役 ， 从公 难 重过 。
济南	清	顾炎武	湖上 荷花 岁岁 新 ， 客中 时序 自 伤神 。 名泉 出地 环 岩郭 ， 急雨 连山 净 火旻 。 绝代 诗题 传 子美 ， 近期 文人 数 于 鳞 。 愁来 独思 辛忠敏P ， 老泪 无端 痛 古人 。
趵突泉L	清	顾我锜	济南L 城西 天下 绝 ， 珍珠 金线 交横 发 。 伏流 到此 倏 复通 ， 平地 跳出 三 白龙 。
重建 古历亭L	清	蒲松龄	大明湖L 上 一 徘徊 ， 两岸 垂杨 荫 绿苔 。 大雅 不随 芳草 没 ， 新亭 仍傍 碧流 开 。 雨余 水涨 双 堤远 ， 风起 荷香 四面 来 。 遥羡 当年 贤太守L ， 少陵P 嘉宾 得 追陪 。
游 湖L 绝句	明	张鹤鸣	佛山L 影落 镜湖 秋 ， 湖上 看山 翠 欲流 。 花外 小舟 吹笛 过 ， 月明 香动 水云舟 。
经 鲁L 祭 孔子P 而 叹 之	唐	李隆基	夫子P 何为 者 ？ 栖栖 一代 中 。 地犹 鄹氏 邑 ， 宅 即 鲁王宫L 。 叹凤 嗟身 否 ， 伤麟 怨 道穷 。 今看 两 楹奠 ， 当与 梦 时同 。
颂 鲁L	唐	苏拯	天推 鲁仲尼P ， 周游 布 典坟 。 游遍 七十 国 ， 不令 遇 一君 。 一国 如 一遇 ， 单车 不转 轮 。 良由 至 化力 ， 为国 不为 身 。 礼乐 行 未足 ， 邅回 危 于 陈 。 礼乐 今 有余 ， 袞旒 当 圣人 。 伤哉 绝粮 议 ， 千载 误 云云 。
代 文宣王P 答	唐	罗隐	三教 之中 儒 最尊 ， 止戈 为武 武 尊 文 。 吾今 尚自 披 蓑笠 ， 你 等 何须 读 典坟 。 释氏 宝楼 侵 碧汉 ， 道家 宫殿 拂 青云 。 若教 颜闵P 英灵 在 ， 终不 羞他 李老君 。
谒 孔林L	金	党怀英	鲁国L 遗迹 堕 渺茫 ， 独余 村庙 压 城荒 。 梅梁 分曙 霞栖 影 ， 松牖 回春 日 驻光 。 老桧 曾沾 周 雨露 ， 断碑 犹是 汉 文章 。 不须 更问 传家 久 ， 泰岱L 参天 汶泗 长 。
康熙L 甲子T 冬至T 过 阙宫	清	玄烨	銮辂 来 东鲁L ， 先登 夫子堂L 。 两楹 陈俎 豆 ， 数仞 见 宫墙 。 道统 唐虞P 接 ， 儒风 洙泗 长 。 入门 抚 松柏 ， 瞻拜 肃 冠裳 。
谒 孔林L 酹酒	清	弘历	一杯 如 五岳 ， 永古 此 幽宫 。 天朗 林 原气 ， 川流 洙泗L 风 。 奠椒 溯思 处 ， 瞻楷 不 言中 。 万载 读书 者 ， 水源 木 本同 。
谒 颜庙L	明	于慎行	素王宫阙L 鲁侯 台 ， 兖国 崇祠 此 并开 。 位冠 元公 师 友会 ， 道同 皇佐 古今 才 。 虚亭 玉甃 疏 眢井 ， 旧巷 璇题 销 绣苔 。 门外 依稀 馀辇 路 ， 前朝 曾睹 翠华 来 。
短歌 行	东汉	曹操	对酒 当 歌 ， 人生 几何 ！ 譬如 朝露 ， 去日 苦多 。 慨当 以慷 ， 忧思 难忘 。 何以 解忧 ？ 唯有 杜康 。 青青 子衿 ， 悠悠 我心 。 但为 君故 ， 沉吟 至今 。 呦呦 鹿鸣 ， 食 野之苹 。 我 有 嘉宾 ， 鼓瑟 吹笙 。 明明 如月 ， 何时 可掇 ？ 忧 从中来 ， 不可 断绝 。 越陌 度阡 ， 枉用 相存 。 契阔 谈䜩 ， 心念 旧恩 。 月明 星稀 ， 乌鹊 南飞 。 绕树 三匝 ， 何枝 可依 ？ 山不 厌高 ， 海不 厌深 。 周公P 吐哺 ， 天下 归心 。
登州L 海市	北宋	苏轼	东方 云海 空复空 ， 群仙 出没 空明 中 。 荡摇 浮世 生 万象 ， 岂有 贝阙 藏 珠宫 。 心知 所见 皆 幻影 ， 敢以 耳目 烦 神工 。 岁寒 水冷 天地 闭 ， 为我 起蛰 鞭 鱼龙 。 重楼 翠阜 出 霜晓 ， 异事 惊倒 百岁翁 。
海上 二首	明	王崇庆	长风 吹断 海门 霞 ， 三月T 登州L 始 见花 。 望出 白云 千万里 ， 还疑 天外 有 人家 。 秦皇P 汉武P 亦 雄才 ， 海上 求仙 竟 不来 。 千古 风流 等 春梦 ， 碧桃 岩下 花 自开 。
登 蓬莱阁L 二首	清	崔应阶	一别 沧溟 五十年 ， 蓬莱L 今复 辨 桑田 。 朱颜 大药 求 难得 ， 碧海 青山 境 即仙 。 阆苑 不须 烦 鹤驭 ， 蜃楼 空自 没 苍烟 。 垂髫 犹记 登 瀛路 ， 曾藉 长风 破浪 还 。
过 梁山泊L	北宋	韩琦	巨泽 渺 无际 ， 齐船 度日 撑 。 渔人 骇铙 吹 ， 水鸟 背 旗旌 。 蒲密 遮 如 港 ， 山遥 势 似 彭 。 不知 蒲芰 里 ， 白昼 苦 蚊虻 。
雨 过 梁山L	元	萨都剌	题诗 芦叶 雨 斑斑 ， 底事 诗人 不 奈闲 ？ 满泊 荷花 开 欲 遍 ， 客程 五月T 过 梁山L 。
过 梁山泊L	元	袁桷	飘飘 愧 陈人 ， 历历 见 遗址 。 流移 散 空洲 ， 崛强 寻 故垒 。
题 宋江P 三十六 人 画 赞	元	陆友仁	蔡家 京卞L 出 门下 ， 首乱 中原 倾 大厦 。 京东 宋江P 三十六 ， 白日 横行 大河L 北 。 后来 报国 收 战功 ， 捷书 夜奏 甘泉宫 。 我尝 舟 过 梁山泊L ， 春水 方生 何 渺漠 。 或云 此是 石碣村L ， 至今 闻之 犹 猇魄 。
疏财台L	明	刘基	突兀 高台 累土 成 ， 人言 暴客 此 分赢 。 饮泉 清节 今 寥落 ， 可但 梁山L 独 擅名 。
《 水浒传 》 引言 诗	元	施耐庵	万姓 熙熙 化 育中 ， 三登 之世 乐 无穷 。 岂知 礼乐 笙镛 治 ， 变作 兵戈 剑戟 丛 。 水浒 寨中 屯 节侠 ， 梁山泊L 内 聚 英雄 。 细推 治乱 兴亡 数 ， 尽属 阴阳 造化 功 。
登 崂山L	明	邵贤	坤轴 危分 镇 巨鳌 ， 山如 排戟 战 方鏖 。 钟鼓 镗塔 东西 院 ， 丹碧 参差 大小崂L 。 石柱 华楼 阑海 出 ， 龙岩 狮石 倚 天高 。 我来 无限 登临 意 ， 点染 风烟 信 彩毫 。
赠 任城L 卢主簿P 潜	唐	李白	海鸟 知 天风 ， 窜身 鲁门L 东 。 临觞 不能 饮 ， 矫翼 思 凌空 。 钟鼓 不为 乐 ， 烟霜 谁 与同 。 归飞 未 忍去 ， 流泪 谢 鸳鸿 。
鲁郡L 东石门L 送 杜二甫P	唐	李白	醉别 复 几日 ， 登临 遍 池台 。 何时 石门L 路 ， 重有 金樽 开 ？ 秋波 落 泗水L ， 海色 明 徂徕L 。 飞蓬 各 自远 ， 且尽 手中 杯 。
登 太白楼L	明	王世贞	昔闻 李供奉P ， 长啸 独 登楼 。 此地 一垂 顾 ， 高名 百代 留 。 白云 海色 曙 ， 明月 天门 秋 。 欲觅 重来 者 ， 潺湲 济水 流 。
赠 嵩山L 焦炼师P	唐	李白	二室 凌 青天 ， 三花 含 紫烟 。 中有 蓬海客P ， 宛疑 麻姑仙P 。 八极 恣游 憩 ， 九垓 长周 旋 。 还归 东山L 上 ， 独拂 秋霞 眠 。
嵩山L 采 菖蒲 者	唐	李白	神人 多 古貌 ， 双耳 下垂 肩 。 嵩岳L 逢 汉武P ， 疑是 九疑仙 。 我来 采 菖蒲 ， 服食 可 延年 。 言终 忽 不见 ， 灭影 入 云烟 。 喻帝P 竟 莫悟 ， 终归 茂陵L 田 。
少室L 晴雪 送 王宁P	唐	李颀	少室L 众峰 几峰 别 ？ 一峰 晴见 一峰 雪 。 隔城 半山 连 青松 ， 素色 峨峨 千万 重 。
登 少室山L 寺	唐	褚朝阳	飞阁 青云 里 ， 先秋 独 早凉 。 天花 映窗 近 ， 月桂 拂 檐香 。 华岳L 三峰 小 ， 黄河L 一带 长 。 空间 指 归路 ， 烟处 有 垂杨 。
望 嵩山L	唐	吴融	三十六峰L 危 似冠 ， 晴楼 百尺 独登 看 。 高凌 鸟外 青冥 窄 ， 翠落 人间 白昼 寒 。 不觉 衡阳L 遮雁 过 ， 如何 钟阜 斗 龙蟠 。 始知 万岁 声 常在 ， 只待 东巡 动 玉鸾 。
早春 题 少室L 东岩	唐	白居易	三十六峰L 晴 ， 雪销 岚 气生 。 月留 三夜 宿 ， 春引 四山 行 。 远草 初 含色 ， 寒禽 未 变声 。 东岩 最高 石 ， 唯有 我 题名 。
二室道	北宋	范仲淹	太室L 何 森耸 ， 少室 欲 飞动 。 相对 起 云霞 ， 恍如 游 仙梦 。 何以 宠 此行 ， 行歌 降 神颂 。
中峰L	北宋	范仲淹	嵩岳L 最高 处 ， 逸客 偶 登临 。 回看 日月 影 ， 正得 天地 心 。 念此 非常 游 ， 千载 一 披襟 。
天池L	北宋	范仲淹	岳顶 见 天池L ， 神异 安 可度 。 勿谓 无 波涛 ， 云雷 有时 恶 。 乘此 澄清 间 ， 吾缨 可以 濯 。
望 少室L	金	许安仁	名山 都 不见 真形 ， 万仞 盘盘 入 杳冥 。 安得 云间 骑 白鹤 ， 下看 三十六峰L 青 。
少室L 南原	金	元好问	地僻 人烟 断 ， 山深 鸟语 哗 。 清溪 鸣 石齿 ， 暖日 长 藤芽 。 绿映 高低 树 ， 红迷 远近 花 。 林间 见 鸡犬 ， 直拟 是 仙家 。
望 嵩山L	清	吕守增	三十六峰L 如 髻鬟 ， 行人 来往 舒 心颜 。 白云 蓬蓬 忽然 合 ， 都在 虚无 缥缈 间 。
望 嵩L 高	清	郜锦	故步 嵩L 高 最 上头 ， 晴光 万里 望 中收 。 西临 华岳L 三峰 直 ， 北俯 黄河L 一线 流 。 岚 趁 轻霞 疑 翠幙 ， 云迈 晓日 结 层楼 。 天池 勺水 题诗 罢 ， 乘月 还同 玉女 游 。
游 少林寺L	唐	沈佺期	长歌 游 宝地L ， 徙倚 对 珠林 。 雁塔L 风霜 古 ， 龙池L 岁月 深 。 绀园 澄 夕霁 ， 碧殿 下 秋阴 。 归路 烟霞 晚 ， 山蝉 处处 吟 。
从 龙潭寺L 至 少林寺L 题 赠 同游者	唐	白居易	山屐 田衣 六七贤 ， 搴芳 踏翠 弄 潺湲 。 九龙潭L 月 落 杯酒 ， 三品 松风 飘 管弦 。 强健 且 宜游 胜地 ， 清凉 不觉 过 炎天 。 始知 驾鹤 乘 云天 ， 别有 逍遥 地上 仙 。
奉祀 嵩山L 夜宿 少林寺L	宋	李允中	葱岭L 当时 遇 宋云P ， 手提 只履 果 何因 。 入山 便得 安心法 ， 立雪 能来 断臂人P 。 锡卓 一泓 云 浸影 ， 花开 五叶 地 生春 。 无劳 照石 瞻 遗像 ， 满目 青山 是 法身 。
少林寺L	明	李梦阳	林深 谷暝 客子 入 ， 钟鸣 叶落 秋山 空 。 烟云 细袅 石涧 底 ， 峦岫 乱积 松窗 中 。 唐碑 汉碣 藓字 剥 ， 虎啼 猿啸 罗灯 红 。 独坐 悠悠 息尘 想 ， 少室L 影下 月出 东 。
宿 少林寺L	清	弘历	明日 瞻 中岳L ， 今宵 宿 少林L 。 心依 六禅 静 ， 寺据 万山 深 。 树古 风 留籁 ， 地灵 夕 作阴 。 应教 半岩 雨 ， 发我 夜窗 吟 。
游 少林寺L	金	许安仁	闻说 九年 空 面壁 ， 得逢 二祖 便 传衣 。 千秋 少室L 山灵 在 ， 曾见 先师 只 履归 。
初祖 庵 杂咏 · 面壁石	清	顾嗣立	一石 独 亭亭 ， 中藏 初 祖形 。 千年 神气 在 ， 何用 著 丹青 。
夏日 游 石淙L	唐	武则天	三山 十洞 光 玄箓 ， 玉峤 金峦 镇 紫微 。 均露 均霜 标 胜壤 ， 交风 交雨 列 皇畿 。 万仞 高岩 藏 日色 ， 千寻 幽涧 浴 云衣 。 且驻 欢筵 赏 仁智 ， 雕鞍 薄晚 杂尘 飞 。
嵩阳宫L	明	李化龙	悬崖 绝壁 草 芃芃 ， 传是 嵩阳L 旧 月宫 。 何处 闲云 飞 岭外 ， 有时 佳气 起 封中 。 螭纹 剥落 唐碑 古 ， 虬树 阴森 汉 柏雄 。 指点 千年 成 感慨 ， 悲风 萧飒 万山 空 。
嵩阳书院L	清	阎兴邦	四顾 多 生感 ， 谁为 第一流 。 能超 行迹 外 ， 便与 圣贤 侔 。 汉柏P 千年 古 ， 唐碑 百代 羞 。 莫因 徐浩 笔 ， 偃月 姓名 留 。
嵩阳书院L	清	爱新觉罗·弘历	嵩阳书院L 景 最清 ， 石幢 犹记 故宫L 名 。 虚夸 妙药 求 方士 ， 何似 菁莪 育 俊英 。 山色 溪声 留 宿雨 ， 菊香 竹韵 喜 新晴 。 初来 岂得 无 言别 ， 汉柏 阴中 句 偶成 。
咏 将军柏L	清	李生光	苍盖 摩天 迥 ， 盘根 拔地 雄 。 赐封 来 汉代T ， 结种 在 鸿蒙 。 皮泌 千年 雪 ， 叶留 万古 风 。 茂陵P 人 已故 ， 此柏 自 青丛 。
五噫 歌	东汉	梁鸿	陟彼 北芒L 兮 ， 噫 ！ 顾瞻 帝京 兮 ， 噫 ！ 宫阙 崔巍 兮 ， 噫 ！ 民之 劬劳 兮 ， 噫 ！ 辽辽 未央 兮 ， 噫 ！
名都 篇	东汉	曹植	名都 多 妖女 ， 京洛L 出 少年 。 宝剑 直 千金 ， 被服 丽 且鲜 。 白日 西南 驰 ， 光景 不可 攀 。 云散 还 城邑 ， 清晨 复 来还 。
代 陈思王P 京洛L 篇	南朝	鲍照	凤楼 十二 重 ， 四户 八绮窗 。 珠帘 无 隔露 ， 罗幌 不胜 风 。 宝帐 三千万 ， 为尔 一 朝容 。 春吹 回 白日 ， 霜歌 落 塞鸿 。
京洛L 篇	南朝	萧纲	黄河L 入 洛水 ， 丹泉 绕 射熊 。 谁知 两京L 盛 ， 欢宴 遂 无穷 。
东宫L 春	隋	杨广	洛阳L 城边 朝 日晖 ， 天渊 池前 春燕 归 。 含露 桃花 开 未飞 ， 临风 杨柳 自 依依 。 小苑 花红 洛 水绿 ， 清歌 宛转 繁 弦促 。 长袖 逶迤 动 珠玉 ， 千年 万岁 阳春 曲 。
五凤楼L 晚望	唐	白居易	晴阳 晚照 湿 烟销 ， 五凤楼L 高 天 泬漻 。 野绿 全经 朝雨 洗 ， 林红 半被 暮云 烧 。 龙门L 翠黛 眉 相对 ， 伊水 黄金 线 一条 。 自入 秋来 风景 好 ， 就中 最好 是 今朝 。
上阳宫L	唐	王建	上阳L 花木 不曾 秋 ， 洛水 穿宫 处处 流 。 画阁 红楼 宫女 笑 ， 玉箫 金管 路人 愁 。 幔城 入涧 橙花 发 ， 玉辇 登山 桂叶 稠 。 曾读 列仙 王母 传 ， 九天 未胜 此 中游 。
和秋 游 洛阳L	唐	徐凝	洛阳L 自古 多 才子 ， 唯爱 春风 烂漫 游 。 今到 白家 诗句 出 ， 无人 不咏 洛阳L 秋 。
过 洛阳城L	唐	于武陵	古来 利 与 名 ， 俱在 洛阳城L 。 九陌 鼓 初起 ， 万车 轮 已行 。 周秦T 时 几变 ， 伊洛 水 犹清 。 二月 中桥 路 ， 鸟啼 春草 生 。
春夜 洛城L 闻笛	唐	李白	谁家 玉笛 暗 飞声 ？ 散入 春风 满 故城L 。 此 夜曲 中 闻 折柳 ， 何人 不起 故园 情 。
芙蓉楼L 送 辛渐P	唐	王昌龄	寒雨 连江 夜 入吴 ， 平明 送客 楚山L 孤 。 洛阳L 亲友 如 相问 ， 一片 冰心 在 玉壶 。
过 故 洛阳城L	北宋	司马光	四合 连山 缭绕 青 ， 三川L 滉漾 素 波明 。 春风 不识 兴亡 意 ， 草色 年年 满 故城L 。
过 西京L	宋	穆修	西京L 千古 帝王宫 ， 无限 名园 水竹 中 。 来恨 不逢 桃李 日 ， 满城 红树 正 秋风 。
赏 牡丹	唐	刘禹锡	庭前 芍药 妖 无格 ， 池上 芙蕖 净 少情 。 唯有 牡丹 真 国色 ， 花开 时节 动 京城L 。
牡丹	唐	徐凝	何人 不爱 牡丹花 ， 占断 城中 好 物华 。 疑是 洛川L 神女 作 ， 千娇 万态 破 朝霞 。
东轩 前 色 牡丹 一株 开 二十四枝 ， 成 两绝 呈 诸公	北宋	邵雍	牡丹 一株 开 绝奇 ， 二十四枝 娇娥 围 。 满 洛城L 人 都 不知 ， 邵家 独占 春风 时 。
洛阳L 春吟 八首	北宋	邵雍	洛阳L 人惯 见 奇葩 ， 桃李 花开 未 当花 。 须是 牡丹 花 盛发 ， 满城 方始 乐 无涯 。
白牡丹	明	陆树声	洛阳L 春色 画 图中 ， 幻出 天然 夺 化工 。 不泥 繁华 竞 红紫 ， 一般 清艳 领 东风 。
题 焚经台L	唐	李世民	门径 萧萧 长 绿苔 ， 一回 登此 一 徘徊 。 青牛 漫说 函关 去 ， 白马 亲从 印土 来 。 确实 是非 凭 烈焰 ， 要分 真伪 筑 高台 。 春风 也解 嫌 狼藉 ， 吹尽 当年 道教 灰 。
宿 白马寺L	明	张继	白马 驮经 事 已空 ， 断碑 残刹 见 遗踪 。 萧萧 茅屋 秋风 起 ， 一夜 雨声 羁 思浓 。
邙山L	唐	沈佺期	北邙L 山上 列 坟茔 ， 万古 千秋 对 洛城L 。 城中 日夕 歌钟 起 ， 山上 唯闻 松柏 声 。
北邙L 行	唐	王建	北邙L 山头 少 闲土 ， 尽是 洛阳L 人 旧墓 。 旧墓 人家 归葬 多 ， 堆著 黄金 无 买处 。 天涯 悠悠 葬日 促 ， 冈坂 崎岖 不停 毂 。 高张 素幕 绕 铭旌 ， 夜唱 挽歌 山下 宿 。 洛阳L 城北 复 城东 ， 魂车 祖马 长 相逢 。 车辙 广若 长安L 路 ， 蒿草 少于 松柏 树 。 涧底 盘陀 石 渐稀 ， 尽向 坟前 作 羊虎 。 谁家 石碑 文字 灭 ， 后人 重取 书 年月 。 朝朝 车马 送葬 回 ， 还起 大宅 与 高台 。
洛阳L	清	汪懋麟	千山 紫翠 朝 中岳L ， 万古 歌钟 对 北邙L 。 故国 何人 凭 险阻 ？ 皇天 有意 阅 沧桑 。
祀 洛水L 歌	秦	赢政	洛阳L 之 水 ， 其色 苍苍 。 祀祭 大泽 ， 倏忽 南临 。 洛滨 醊祷 ， 色连 三光 。
天津桥L	唐	白居易	津桥L 东北 斗亭L 西 ， 到此 令人 诗 思迷 。 眉月 晚生 神女 浦 ， 脸波 春傍 窈娘 堤 。 柳丝 袅袅 风 缲出 ， 草缕 茸茸 雨 剪齐 。 报道 前驱 少 呼喝 ， 恐惊 黄鸟 不成 啼 。
洛神	元	雅琥	漫说 君王P 留 宝枕 ， 不闻 仙子 和 琼箫 。 肠断 洛川L 东 去水 ， 野烟 汀草 共 萧萧 。
游 龙门L 奉先寺L	唐	杜甫	已从 招提 游 ， 更宿 招提 境 。 阴壑 生 虚籁 ， 月林 散 清影 。 天阙 象纬 逼 ， 云卧 衣裳 冷 。 欲觉 闻 晨钟 ， 令人 发 深省 。
龙门L 游眺	唐	韦应物	凿山 导 伊流 ， 中断 若 天辟 。 都门 遥 相望 ， 佳气 生 朝夕 。 精舍 绕 层阿 ， 千龛 邻 峭壁 。 日落 望 都城L ， 人间 何 役役 。
无题	北宋	苏过	峥嵘 两 山门 ， 共挹 一 水秀 。 滩声 千鼓 辇 ， 石壁 万龛 窦 。 金银 佛寺 古 ， 夜籁 笙竽 奏 。 惟当 效 乐天P ， 早晚 弃 冠绶 。
龙门L 山色	明	吕维祺	劈破 层峦 一水 来 ， 俨然 双阙 向城 开 。 千龛 佛像 唐T 雕凿 ， 万世 神功 禹P 削裁 。
关夫子墓L 瞻拜 有 纪	清	周有德	昔年 谒 孔陵L ， 海岱 萃 其灵 。 今拜 关公墓L ， 乍见 洛水 清 。 乾坤 留 正气 ， 不死 文武 英 。 河岳 昭 明德 ， 长此 酹椒 馨 。
咏怀 古迹	唐	杜甫	诸葛P 大名 垂 宇宙 ， 宗臣 遗像 肃 清高 。 三分 割据 纡筹 策 ， 万古 云霄 一 羽毛 。 伯仲 之间 见 伊吕P ， 指挥 若定 失 萧曹P 。 运移 汉祚 终 难复 ， 志决 身歼 军务 劳 。
咏怀 诗	东汉	阮藉	徘徊 蓬池L 上 ， 还顾 望 大梁L 。 绿水 扬 洪波 ， 旷野 莽 茫茫 。
咏怀 诗	东汉	阮藉	驾言 发 魏都L ， 南向 望 吹台 。 箫管 有 遗音 ， 梁王P 安在 哉 ？ 战士 食 糟糠 ， 贤者 处 蒿莱 。 歌舞 曲 未终 ， 秦兵 复 已来 。 夹林 非 我有 ， 朱宫 生 尘埃 。 军败 华阳L 下 ， 身竟 为 土灰 。
寄 汴州L 令狐相公P	唐	王建	三军 江口 拥 双旌 ， 虎帐 长开 自 教兵 。 机锁 恶徒 狂寇 尽 ， 恩驱 老将 壮心 生 。 水门 向晚 茶商 闹 ， 桥市 通宵 酒客 行 。 秋日 梁王P 池阁 好 ， 新歌 散入 管弦 声 。
汴路L 即事	唐	王建	千里 河烟 直 ， 青槐 夹岸 长 。 天涯 同此 路 ， 人语 各 殊方 。 草市 迎 江货 ， 津桥L 税 海商 。 回看 故宫L 柳 ， 憔悴 不 成行 。
汴京L 纪事	南宋	刘子翚	梁园L 歌舞 足 风流 ， 美酒 如刀 解 断愁 。 忆得 承平 多 乐事 ， 夜深 灯火 上 樊楼L 。
万岁山L 图	元	元明善	万岁L 纲船 出 太湖L ， 九朝 膏血 一时 枯 。 阿 谁 种下 中原 祸 ？ 犹自 昂藏 入画图 。
南京L 遇 仙楼	金	刘祁	倚天 突兀 耸 高楼 ， 楼上 人家 白玉 钩 。 落日 笙歌 迷 汴水L ， 春风 灯火 似 扬州L 。
梁园L 吟	唐	李白	我浮 黄河L 去 京阙L ， 挂席 欲进 波连山L 。 天长 水阔 厌 远涉 ， 访古 始及 平台 间 。 平台 为客 忧思 多 ， 对酒 遂作 梁园 歌 。 却忆 蓬池 阮公 咏 ， 因 吟 绿水 扬 洪波 。 梁王P 宫阙 今 安在 ？ 枚马 先归 不 相待 。 舞影 歌声 散 渌池 ， 空余 汴水 东流 海 。
宋中L 十首	唐	高适	梁王P 昔 全盛 ， 宾客 复 多才 。 悠悠 一千 年 ， 陈迹 唯 高台 。 寂寞 向 秋草 ， 悲风 千里 来 。
遣怀	唐	杜甫	昔我 游 宋中 ， 惟 梁孝王都L 。 忆与 高李辈P ， 论交 入 酒垆 。 两公 壮 藻思 ， 得我 色 敷腴 。 气酣 登 吹台 ， 怀古 视 平芜 。
禹P 王台 乾隆P 诗碑	清	爱新觉罗·弘历	京国L 探 遗迹 ， 苔碑 率 隐埋 。 胜日 停 銮跸 ， 凌晨 陟 吹台 。 杜子P 真 豪 矣 ， 梁王P 安在 哉 ？ 无须 命 长笛 ， 为恐 豫云 开 。
汴梁L 竹枝 词	清	周劼	一湾 绿树 禹王台L ， 时节 清明T 花 正开 。 相约 邻家 诸 姐妹 ， 明朝T 城外 踏青 来 。
登 相国寺L 阁	唐	刘商	晴日 登临 好 ， 春风 各 望家 。 垂杨 夹 城路 ， 客思 逐 杨花 。
秋雪 过 相国寺L	宋	刘攽	六花 飞舞 满 长安L ， 古寺 楼台 白玉 攒 。 长眉 老僧 见客 语 ， 两年 秋雪 就 中寒 。
登 相国寺L 资 圣阁	元	陈孚	大相国寺L 天下 雄 ， 天梯 缥缈 凌 虚空 。 三千 歌吹 灯火 上 ， 五百 缨缦 烟云 中 。 洛汭 已淹 西坠 日 ， 汉津 空送 南飞 鸿 。 栏干 倚遍 忽 归去 ， 飒飒 两鬓 生 秋风 。
登 相国寺L 藏经阁	明	顾禄	金碧 棱层 炫 晓霞 ， 梵王P 高阁 壮 中华 。 上摩 绛阙 三千界 ， 下瞰 红尘 十万家 。 伏虎 神僧 翻 贝叶 ， 乘鸾 仙女 散 瑶花 。 何因 证得 无生 果 ， 来从 云中 驾 鹿车 。
闻 相国寺L 钟声	清	陈浩	古寺L 钟声 远 ， 寒宵 动 旅情 。 因风 时 断续 ， 和月 共 凄清 。 不是 音尘 寂 ， 谁知 大小 鸣 。 揽衣 灯 尽暗 ， 坐待 纸窗 明 。
相国寺L 庙会	清	李于潢	到门 蛮语 学 京腔 ， 僧院 繁华 号 破赃 。 朔望T 才过 又 三八 ， 赁驴 人满 信陵坊L 。
铁塔L 燃灯	元	冯子振	擎天 一柱 碍 云低 ， 破暗 功同 日月 齐 。 半夜 火龙 翻 地轴 ， 八方 星象 下 天梯 。 光摇 潋滟 沿 珠蚌 ， 影落 沧溟 照 水犀 。 文焰 逼人 高 万丈 ， 倒提 铁笔 向空 题 。
铁塔L	清	侯朴	浮屠 铁色 自 康年 ， 石磴 登临 落照 边 。 北望 大河L 盘 白气 ， 西看 少室 起 青烟 。 云低 艮岳 豪华 尽 ， 日射 孤城 睥睨 悬 。 搔首 乾坤 聊 纵目 ， 归鸿 几处 叫 长天 。
汴梁L 竹枝 词	清	周劼	繁塔L 难齐 铁塔L 高 ， 铃声 遥带 野风 飘 。 年年 八月 中秋夜 ， 万点 明灯 彻九霄 。
龙亭L 怀古	清	宋继郊	青猊 绰楔 双 蹲处 ， 便是 当年 宣德楼L 。 珠瀑 千条 冰虎 戏 ， 莲灯 万盏 火龙 游 。 露台 仙乐 围 宫扇 ， 朵殿 天风 烁 彩球 。 星物 不殊 陵谷 改 ， 白鸥 浮没 荻花 秋 。
龙亭L 怀古	清	陈简	龙亭L 高耸 碧云 隈 ， 趁晓 登临 眼界 开 。 紫气 东随 函谷 至 ， 黄河L 西抱 太行L 来 。 夕阳 石马 秋风 冷 ， 故国 铜驼 暮雨 哀 。 遥望 宋宫 烟水 际 ， 当年 禾黍 亦 成灰 。
登 广武L 古战场 怀台	唐	李白	伊昔 临 广武L ， 连兵 决 雌雄 。 分我 一杯 羹 ， 太皇P 乃 汝翁 。 战争 有 古迹 ， 壁垒 颓 层穹 。 猛虎 吟 洞壑 ， 饥鹰 鸣 秋空 。 沈湎 呼 竖子 ， 狂言 非 至公 。 抚掌 黄河L 曲 ， 嗤嗤 阮嗣宗P 。
甘露寺L	宋	苏轼	古今 共 一轨 ， 后世 徒 辛酸 。 聊兴 广武P 叹 ， 不待 雍门P 弹 。
田舍 即事 十首	南宋	刘克庄	儿女 相携 看 市优 ， 纵谈 楚汉 割 鸿沟 。 山河 不暇 为 渠惜 ， 听到 虞姬P 直是 愁 。
奉赠 韦左丞P 丈 二十二 韵	唐	杜甫	甫P 昔 少年日 ， 早充 观 国宾 。 读书 破 万卷 ， 下笔 如 有神 。 赋料 扬雄P 敌 ， 诗看 子建P 亲 。 自谓 颇 挺出 ， 立登 要 路津 。 致君 尧P 舜P 上 ， 再使 风俗 淳 。 此意 竟 萧条 ， 行歌 非 隐沦 。 今欲 东入 海 ， 即将 西去 秦 。 尚怜 终南山 ， 回首 清 渭滨 。 白鸥 没 浩荡 ， 万里 谁能 驯 ？
经 少陵墓L	明	周叙	杜陵L 诗客 墓 ， 遥依 北邙L 巅 。 断碑 居 人识 ， 高明 信史 传 。 猿声 悲洛 照 ， 对色 翳 寒烟 。 惟有 文章 在 ， 辉光 夜 烛天 。
白乐天墓L	清	靳志	乐天P 晚知 洛 ， 而亦 有所 敝 。 手抄 洛中 集 ， 纳之 香山P 寺 。 十寺 今 无一 ， 苍然 岂 天意 。 巉巉 凿 龙门 ， 清伊 细 如带 。 终古 付 劫灰 ， 何处 认 初地 。 嗟嗟 长庆 体 ， 今犹 立 文字 。
遗恨 殷郊L	明	夏完淳	遗恨 殷郊L 太白 旗 ， 黄虞 千载 更 无依 。 当时 尚有 顽民 在 ， 何事 西山 独 采薇 。
鹦鹉洲L 送 王九P 之 江左	唐	孟浩然	昔登 江上 黄鹤楼L ， 遥爱 江中 鹦鹉洲L 。 洲势 逶迤 绕 碧流 ， 鸳鸯 鸂鶒 满 滩头 。 滩头 日落 沙碛 长 ， 金沙 熠熠 动 飙光 。 舟人 牵 锦缆 ， 浣女 结 罗裳 。 月明 全见 芦花 白 ， 风起 遥闻 杜若 香 。 君行 采采 莫 相忘 。
黄鹤楼L 送 康太守P	唐	王维	城下 沧江L 水 ， 高高 黄鹤楼L 。 朱栏 将 粉堞 ， 江水 映 悠悠 。 铙吹 发 夏江 ， 使君 在 上头 。 郭门 隐 枫岸 ， 候吏 趋 芦洲 。 何异 临 川郡 ， 还封 康乐侯P 。
黄鹤楼L	唐	崔颢	昔人 已乘 黄鹤 去 ， 此地 空余 黄鹤楼L 。 黄鹤 一去 不 复返 ， 白云 千载 空 悠悠 。 晴川 历历 汉阳L 树 ， 芳草 萋萋 鹦鹉洲L 。 日暮 乡关 何处 是 ， 烟波 江上 使人 愁 。
黄鹤楼L 送 孟浩然P 之 广陵L	唐	李白	故人 西辞 黄鹤楼L ， 烟花 三月 下 扬州L 。 孤帆 远影 碧空 尽 ， 唯见 长江L 天际 流 。
与 史郎P 中饮 听 黄鹤楼L 上 吹笛	唐	李白	一为 迁客 去 长沙L ， 西望 长安L 不见 家 。 黄鹤楼L 中 吹 玉笛 ， 江城 五月T 落 梅花 。
江夏L 送 友人	唐	李白	雪点 翠云 裘 ， 送君 黄鹤楼L 。 黄鹤 振 玉羽 ， 西飞 帝王州L 。 凤无 琅玕 实 ， 何以 赠 远游 。 徘徊 相 顾影 ， 泪下 汉江L 流 。
黄鹤楼L	唐	贾岛	高槛 危楼 势 若飞 ， 孤云 野水 共 依依 。 青山 万古 长 如旧 ， 黄鹤 何年 去 不归 。 岸映 西州城L 半出 ， 烟生 南浦L 树 将微 。 定知 羽客 无因 见 ， 空使 含情 对 落辉 。
卢侍御P 与 崔评事P 为 予 于 黄鹤楼L 置宴 ， 宴罢 同望	唐	白居易	江边 黄鹤L 古时楼 ， 劳致 华筵 待 我游 。 楚思 渺茫 云水 冷 ， 商声 清脆 管弦 秋 。 白花 浪溅 头陀寺L ， 红叶 林笼 鹦鹉洲L 。 总是 平生 未行 处 ， 醉来 堪赏 醒 堪愁 。
题 黄鹤楼L 石照	唐	吕岩	黄鹤L 楼前 吹笛 时 ， 白苹 红蓼 满 江湄 。 衷情 欲诉 谁能 会 ？ 惟有 清风 明月 知 。
黄鹤楼L	唐	卢郢	黄鹤L 何年 去 杳冥 ？ 高楼 千载 倚 江城 。 碧云 朝卷 四山 景 ， 流水 夜传 三峡L 声 。 柳暗 西州L 供 骋望 ， 草芳 南浦L 遍 离情 。 登临 一晌 须 回首 ， 看却 乡心 万感 生 。
赋 黄鹤楼L 赠 李公择	北宋	苏辙	一麾 夏口L 亦 何有 ？ 高楼 黄鹤L 慰 平生 。 荆江L 洞庭L 春浪 起 ， 汉沔L 初来 入 江水 。 高城 枕山 望 如带 ， 华榱 照日 光 流渊 。 谁道 武昌L 岸下 鱼 ， 不如 建业L 城边 水 。
鄂州L 南楼	宋	范成大	谁将 玉笛 弄 中秋 ， 黄鹤L 飞来 识 旧游 。 汉树L 有情 横 北渚 ， 蜀江L 无语 抱 南楼 。 烛天 灯火 三更市 ， 摇月 旌旗 万里 舟 。 却笑 鲈乡L 垂钓 手 ， 武昌L 鱼好 便 淹留 。
黄鹤楼L	南宋	陆游	手把 仙人 绿 玉杖 ， 吾行 忽及 早秋 期 。 苍龙 阙角 归 何晚 ， 黄鹤L 楼中 醉 不知 。 江汉 交流 波 渺渺 ， 晋唐T 遗迹 草 离离 。 平生 最喜 听 长笛 ， 裂石 穿云 何处 吹 。
鄂渚 烟波亭L	南宋	戴复古	倚遍 南楼 更 鹤楼L ， 小亭 潇洒 最 宜秋 。 接天 烟浪 来 三峡L ， 隔岸 楼台 又 一州 。 豪杰 不生 机事 息 ， 古今 无尽 大江 流 。 凭栏 日暮 怀乡 国 ， 崔颢P 诗中 旧日 愁 。
黄鹤楼L	宋	游仪	长江L 巨浪 拍天 浮 ， 城郭 相望 万景 收 。 江水 北吞 云梦 入 ， 蜀江L 西带 洞庭L 流 。 角声 交送 千家月 ， 帆影 中分 两岸 秋 。 黄鹤L 楼高 人 不见 ， 却随 鹦鹉 过 江州 。
登 黄鹤楼L	南宋	刘鉴	西风 吹我 登 黄鹤L ， 白云 半在 栏干角 。 题诗 不见 旧时人P ， 惟见 青山 俯 城郭 。 萋萋 芳草 鹦鹉洲L ， 江水 滚滚 无时 休 。 岁月 俯仰 成 春秋 ， 古人 今人 无限 愁 。
登 黄鹤楼L	元	陈孚	黄鹤L 楼前 木叶 黄 ， 白云 飞尽 岸 茫茫 。 橹声 摇月 归 巫峡L ， 灯影 随潮 过 汉阳L 。 庾令 有尘 污 汗简 ， 祢生 无土 盖 文章 。 阑干 空有 当年 柳 ， 留与 行人 说 武昌L 。
登 黄鹤楼L	明	董朴	今古 人多 悦 此楼 ， 湖湘 胜概 可 全收 。 吴山L 远与 楚山L 会 ， 汉水L 始同 江水L 流 。 梦想 每嫌 尘俗 扰 ， 登临 犹有 庙廊 忧 。 眼中 最喜 金陵L 客 ， 欲占 风光 却 早休 。
秋日T 登 黄鹤楼L 怀 刘皋P	明	宋登春	黄鹤P 楼前 江水 流 ， 故人 何处 木兰 舟 ？ 双双 燕子 南飞 去 ， 芦花 铁笛 秋 瑟瑟 。
登 黄鹤楼L	明	吴国伦	黄鹤L 仙人 去 不回 ， 海滨 楼阁 迥 崔嵬 。 千帆 雨色 当窗 过 ， 万里 江声 动地 来 。 云梦 天低 湘女L 怨 ， 洞庭 叶下 楚臣L 哀 。 当时 玉笛 今 寥落 ， 独有 梅花 照 客杯 。
登 黄鹤楼L	明	毛一公	十里 江城 入望 来 ， 晴川L 烟树 面江 开 。 等闲 折尽 寒堤 柳 ， 此际 何堪 更 落梅 。
黄鹤楼L 看雪	元末明初	杨基	黄鹤L 楼前 水 平岸 ， 春雪 当空 舞 撩乱 。 东风 知有 客 登楼 ， 助以 琼瑶 作 奇观 。 昔人 黄鹤 去 不回 ， 我骑 白凤 横江 来 。 遥看 历历 汉阳L 树 ， 一色 尽是 梨花 开 。
雪中 再登 黄鹤楼L	元末明初	杨基	平生 不愿 万户侯 ， 亦不 愿识 韩荆州P 。 但愿 武昌L 连日 雪 ， 日日 醉登 黄鹤楼L 。 楼前 绝景 冠 今古 ， 况有 缤纷 雪花 舞 。 玉树 参差 认 汉阳L ， 银州L 浩荡 迷 鹦鹉 。
黄鹤楼L	清	钟令嘉	谁见 鹤 飞去 ？ 神仙 不再 过 。 招魂 才士 尽 ， 遗韵 酒人 多 。 文字 风 犹霸 ， 江山 气 不磨 。 南朝T 资 锁钥 ， 天险 究 如何 ？
黄鹤楼L	清	张维屏	仙人 去后 词人 去 ， 但见 长江L 日夜 流 。 江上 白云 应 万变 ， 楼前 黄鹤 自 千秋 。 沧桑 易使 乾坤 老 ， 风月 难消 古今 愁 。 惟有 多情 是 春草 ， 年年 新绿 满 芳洲 。
黄鹤行L	清	简能	黄鹤 黄鹤 何时 来 ？ 赤凤 西走 金乌 催 。 仙翁 爱酒 烟霞 开 ， 黄鹤 一骑 骖 云雷 。 铁笛 横吹 壮士 哀 ， 积风 负翼 孤 徘徊 。 我闻 鹰献 楚王台L ， 鹏雏 毛血 如 云堆 。 仙翁 招手 唤 天台 ， 黄鹤 黄鹤 何时 来 ？
满江红 · 寄 鄂州L 朱使君P 寿昌	宋	苏轼	江汉 西来 ， 高楼 下 ， 葡萄 深碧 。 犹 自带 ， 岷峨L 雪浪 ， 锦江L 春色 。 君是 南山 遗爱 守 ， 我为 剑外 思 归客 。 对此 间 ， 风物 岂 无情 ， 殷勤 说 。 江表 传 ， 君休 读 ； 狂处士P ， 真堪 惜 ！ 空洲 对 鹦鹉 ， 苇花 萧瑟 。 独笑 书生 争 底事 ， 曹公P 黄祖P 俱 飘忽 。 愿使 君 ， 还赋 谪仙P 诗 ， 追 黄鹤 。
满江红 · 登 黄鹤楼L 有感	南宋	岳飞	兵 安在 ？ 膏锋 锷 ； 民 安在 ， 填 沟壑 。 叹 江山 如故 ， 千村 寥落 ， 何日 请缨 提 锐旅 ， 一鞭 直渡 清河 洛 。 却 归来 ， 再续 汉阳L 游 ， 骑 黄鹤 。
水调歌头 · 中秋T 饮 南楼L	南宋	范成大	细数 十年事 ， 十处 过 中秋T 。 今年 新梦 ， 忽到 黄鹤L 旧 山头 。 老子 个中 不浅 ， 此会 天教 重见 ， 今古 一南楼L 。 星汉 淡 无色 ， 玉镜 独 空浮 。 敛 秦烟 ， 收 楚雾 ， 熨 江流 。 关河 离合 ， 南北 依旧 照 清愁 。 想见 姮娥P 冷眼 ， 应笑 归来 霜鬓 ， 空敝 黑貂裘 。 酾酒 问 蟾兔 ， 肯去 伴 沧洲L 。
望 鹦鹉州L 悲 祢衡P	唐	李白	魏帝P 营 八极 ， 蚁观 一 祢衡P 。 黄祖P 斗 筲人 ， 杀之 受 恶名 。 吴江 赋 鹦鹉 ， 落笔 超 群英 。 锵锵 振 金玉 ， 句句 欲 飞鸣 。 至今 芳洲 上 ， 兰蕙 不忍 生 。
鹦鹉洲L	唐	李白	鹦鹉 来过 吴江 水 ， 江上 洲传 鹦鹉 名 。 鹦鹉 西飞 陇山L 去 ， 芳洲 之树 何 青青 。 烟开 兰叶 香风 暖 ， 岸夹 桃花 锦浪 生 。 迁客 此时 徒 极目 ， 长洲L 孤月 向谁 明 。
经 离乱 后 天恩 流夜郎 忆 旧游 书怀	唐	李白	一忝 青云客 ， 三登 黄鹤楼L 。 顾惭 祢 处士 ， 虚对 鹦鹉洲L 。 樊山L 霸气 尽 ， 廖落 天地 秋 。
自 夏口L 至 鹦鹉洲L 望 岳阳L 寄 元中丞	唐	刘长卿	江洲L 无浪 复 无烟 ， 楚客 相思 亦 渺然 。 汉口L 夕阳 斜 度鸟 ， 洞庭L 秋水 远 连天 。 孤城 背岭 寒 吹角 ， 独树 临江 夜 泊船 。 贾谊 上书 忧 汉室 ， 长沙L 谪去 古今 怜 。
登 黄鹤楼L 二首	清	许虬	黄鹤 仙人 不 少留 ， 洲名 鹦鹉 更 堪愁 。 三湘 登眺 还 吾辈 ， 千古 江山 独 此楼 。 沧桑 尽付 邯郸L 枕 ， 烟月 全消 玉笛 声 。 惟有 芳洲 春草 色 ， 年年 还傍 大江 生 。
雨霁 登 黄鹤楼L	清	李鼎元	无边 楚色 潇潇雨 ， 不断 江声 浩浩风 。 鹦鹉洲L 连春 草绿 ， 凤凰山L 带 夕阳红 。 白云 霭霭 仙人去 ， 万古 愁销 一笛 中 。
晴川阁L 野眺	明	傅淑训	江上 风烟 望 武昌L ， 临江 高阁 晓 苍苍 。 涛声 八月T 蛟龙 吼 ， 霸气 千秋 草树 荒 。 几点 青山 浮 大别 ， 一声 残笛 弄 沧浪 。 自经 崔颢P 题诗 后 ， 别是 人间 翰墨场 。
登 晴川阁L 望 武昌L	明	袁宏道	霜崖 突出 藓纹斑 ， 铁笛 临风 去 不还 。 百里 帆樯 千时水 ， 一层 城郭 几层 山 。 遥知 郁郁 葱葱 地 ， 只在 熙熙 攘攘 间 ， 沙鸟 窥鱼 鸥 觅渚 ， 试看 何物 是 清闲 ？
登 晴川阁L	清	程封	凭栏 高倚 半 江秋 ， 楚国L 晴川 第一楼 。 远水 乱从 巴蜀L 下 ， 残碑 都为 宋元 留 。 洲传 鹦鹉 迷 何处 ？ 浪起 鲸鲵 斗 未休 。 罗立 众峰 皆 画本 ， 当年 崔颢P 不 应愁 。
登 晴川阁L	清	孔尚任	重重 烟树 客 愁埋 ， 身到 危栏 倦眼 开 。 江上 大苏P 歌 雪浪 ， 窗中 小李P 画 丹台 。 雄城 山势 趋吴 去 ， 闹市 人声 过 汉来 。 独叹 浮生 无 鹤翅 ， 腊残 还对 楚江 梅 。
晴川阁L	清	何人鹤	大别山L 之麓 ， 晴川L 景 最明 。 潮吞 荆江 月 ， 楼压 武昌城L 。 槛外 分 江汉 ， 云中 辨 岳衡 。 登临 窥 禹踪 ， 挂席 又 南征 。
大雪 登 晴川阁L	清	程三桢	玉龙 三百万 ， 飞落 大江L 寒 。 天地 莽 空阔 ， 诗人 独 倚阑 。 腰间 霜 锷白 ， 席上 酒瓶 干 。 径欲 骑 黄鹤 ， 北风 吹 羽翰 。
汉阳L 晴川阁L 	清	查慎行	已失 当年 鹦鹉洲L ， 晴川L 高阁 劫灰 留 。 苦嫌 过客 多 题壁 ， 却笑 神仙 尽 好楼 。 粉堵 日斜 浮 鄂渚 ， 蒲帆 风急 下 黄州L 。 山根 一线 分 江汉 ， 不遣 清流 混浊 流 。
黄鹤楼L	清	刘子壮	晴川L 与 黄鹤 ， 气势 遥 纵横 。 静见 水声 合 ， 空疑 山势 争 。 三洲 秋色 远 ， 万树 舞 风清 。 帆影 中 流处 ， 遥遥 江汉情 。
送 储邕P 之 武昌L	唐	李白	黄鹤 西楼L 月 ， 长江 万里 情 。 春风 三十度 ， 空忆 武昌城L 。 诺谓 楚人 重 ， 诗传 谢脁P 情 。 沧浪 吾 有曲 ， 寄语 棹 歌声 。
送 谢山人P 归 江夏L	唐	陈陶	黄鹤L 春风 三千里 ， 山人 相期 碧江水 。 携琴 一醉 杨柳 堤 ， 日暮 龙沙 白云 起 。
寄 阮郎P	隋	张碧兰	郎如 洛阳L 花 ， 妾似 武昌L 柳 。 两地 惜 春风 ， 何时 一 携手 。
答 武昌L 吴广文P	南宋	高似孙	平生 不识 武昌L 楼 ， 官柳 青青 好在 不 ？ 庾亮P 笛吹 黄鹤 月 ， 简栖 碑驳 碧苔 秋 。 山横 赤壁L 含情 断 ， 水出 瞿塘 快意 流 。 何处 叫君 同 一醉 ， 并舟 秦女P 擘 箜篌 。
送 卫进士P 推 武昌L	明	何景明	少年 佐郡 楚城 居 ， 十县 风流 尽 不如 。 此去 且随 彭蠡 雁 ， 何须 不食 武昌L 鱼 。 仙人 楼阁 春云 里 ， 估客 帆樯 照晚 余 。 大别山L 前 江 汉水 ， 画帘 终日 对 清虚 。
梦 武昌L	元	揭傒斯	黄鹤L 楼前 鹦鹉洲L ， 梦中 浑似 昔时 游 。 苍山 斜入 三湘路L ， 落日 平铺 七泽L 流 。 鼓角 沈雄 遥 动地 ， 帆樯 高下 乱 维舟 。 故人 虽在 多 分散 ， 独向 南池 看 白鸥 。
梦登 黄鹤楼L 有作 ， 寤 而 续成	明	王格	武昌L 城外 汉江 头 ， 万古 乾坤 万古 流 。 可叹 孙郎P 鱼 不食 ， 年年 血战 取 荆州L 。 清江 泚泚 石 麟麟 ， 月照 当年 幕府 宾 。 谁向 胡床 夸 兴废 ， 西风 尘起 却 污人 。 鹦鹉洲L 前 草色 青 ， 白头 浪里 见 扬舲 。 请看 石椁 何人 骨 ？ 夜夜 江声 打不醒 。 矶头 江水 浪 层层 ， 矶上 楼高 不可登 。 何事 当时 陈少主P ， 西风 一夜 过 金陵L 。
中秋T 夜泊 武昌L	唐	刘淑柔	两城 相 对峙 ， 一水 向 东流 。 夜素 娥月 ， 何年 黄鹤楼L ？ 悠悠 兰棹 晚 ， 渺渺 荻花 秋 。 无奈 柔肠 断 ， 关山L 总是 愁 。
水调歌头 · 折尽 武昌L 柳	宋	辛弃疾	折尽 武昌L 柳 ， 挂席 上 潇湘L 。 二年 鱼鸟 江上 ， 笑我 往来 忙 。 富贵 何时 休问 ， 离别 中年 堪恨 ， 憔悴 鬓 成霜 。 丝竹 陶 写耳 ， 急羽 且 飞觞 。 序 兰亭L ， 歌 赤壁L ， 绣衣 香 。 使君 千骑 鼓吹 ， 风采 汉侯王P 。 莫把 骊驹 频唱 ， 可惜 南楼 佳处 ， 风月 已 凄凉 。 在家 贫 亦好 ， 此语 试 平章 。
水调歌头 · 题 李季允 侍郎 鄂州 吞云楼	南宋	戴复古	轮奂 半天 上 ， 胜概 压 南楼 。 筹边 独坐 ， 岂欲 登临 豁 双眸 ？ 浪说 胸吞 云梦 ， 直把 气吞 残虏 ， 西北 望 神州 。 百载 好 机会 ， 人事 恨 悠悠 。 骑 黄鹤 ， 赋 鹦鹉 ， 谩 风流 。 岳王 祠畔 ， 杨柳 烟锁 古今 愁 。 整顿 乾坤 手段 ， 指授 英雄 方略 ， 雅志 若 为酬 ！ 杯酒 不在乎 ， 双鬓 恐 惊秋 。
汉阳L 春晚	唐	李群玉	汉阳L 抱 青山 ， 飞楼L 映 湘渚 。 白云 蔽 黄鹤 ， 绿树 藏 鹦鹉L 。 凭高 送 春目 ， 流恨 伤 千古 。 遐想 祢 衡才 ， 令人 怨 黄祖P 。
黄鹤楼L	清	李为霖	晴川 高阁 遥 相峙 ， 芙蓉 花外 汉阳市L 。 贾客 操舟 逐 逝浪 ， 望中 有若 轩 与 轾 。 巍峨 大别 踞 其西 ， 东接 高观 烟 树齐 。 更上 层楼 穷醉 眼 ， 置身 天际 众山 低 。
秋晚 过 归元寺L	清	项翙	野寺 西桥 外 ， 清幽 引 兴赊 。 佛灯 争 白日 ， 鬼火 卷 黄沙 。 池静 安僧 梦 ， 松闲 厌 鸟哗 。 篱边 残照 在 ， 余步 数 秋花 。
怨 诗楚 调示 庞主薄P 邓治中	东晋	陶潜	慷慨 独 悲歌 ， 钟期 信 为 贤 。
伯牙台L	清	张维屏	一片 弹琴石L ， 千秋 过客 寻 。 牙期 偶 相遇 ， 山水 感 知音 。 大木 生 虚籁 ， 高台 俯 阳阴 。 苍凉 怀 古意 ， 猿鹤 助 哀吟 。
登 伯牙台L	清	刘鹗	琴台L 近在 汉江L 边 ， 独立 苍茫 意 惘然 。 后世 但闻 传 古迹 ， 当时 谁解 重 高贤 。 桐焦 不废 钧 天响 ， 人去 空留 漱石泉 。 此地 知音 寻 不着 ， 乘风 海上 访 成连 。
江上 吟	唐	李白	屈平P 词赋 悬 日月 ， 楚王P 台榭 空 山邱 。 功名 富贵 若 长在 ， 汉水 亦应 西北 流 。
与 秦少章P 题 《 汉江L 远帆 》	宋	晃冲之	楚山L 全 控蜀 ， 汉水L 半 吞吴 。 老眼 识 佳处 ， 曾看 八境图 。
重赠 吴国宾P	明	边贡	汉江L 明月 照 归人 ， 万里 秋风 一叶 身 。 休把 客衣 轻 浣濯 ， 此中 犹有 帝京L 尘 。
舟泊 汉江L	明	张居正	枫林 霜叶 净 江烟 ， 锦石 游鱼 清 可怜 。 贾客 帆樯 云里 见 ， 仙人 楼阁 镜中 悬 。 九秋 槎影 横 清汉 ， 一笛 梅花 落 远天 。 无限 沧洲L 渔父 意 ， 夜深 高咏 独 鸣舷 。
念奴娇 · 赤壁L 怀古	宋	苏轼	大江L 东去 ， 浪 淘尽 千古 风流 人物 。 故垒 西边 ， 人 道是 三国 周郎P 赤壁L 。 乱石 穿空 ， 惊涛 拍岸 ， 卷起 千堆 雪 。 江山 如画 ， 一时 多少 豪杰 。 遥想 公瑾P 当年 ， 小乔P 初嫁 了 ， 雄姿 英发 。 羽扇 纶巾 ， 谈笑 间 ， 樯橹 灰飞 烟灭 。 故国 神游 ， 多情 应 笑我 ， 早生 华发 。 人生 如梦 ， 一尊 还酹 江月 。
江城子 · 梦中 了了	宋	苏轼	梦中 了了 醉中 醒 。 只 渊明P ， 是 前生 ， 走遍 人间 ， 依旧 却 躬耕 。 昨夜 东坡P 春雨 足 ， 乌鹊 喜 ， 报新 晴 。
东坡	宋	苏轼	雨洗 东坡P 月色 清 ， 市人 行尽 野人 行 。 莫嫌 荤确 坡头 路 ， 自爱 铿然 曳杖 声 。
满庭芳 · 归去来 兮	宋	苏轼	归去来 兮 ， 吾 归何处 ？ 万里 家 在 岷峨L 。 百年 强半 ， 来日 苦 无多 。 坐见 黄州L 再闰 ， 儿童 尽楚 语 吴歌 。 山中 友 ， 鸡豚 社酒 ， 相劝 老东坡P 。
江间作	北宋	潘大临	西山L 连 虎穴 ， 赤壁L 隐 龙宫 。 形胜 三分国 ， 江流 万世 功 。 沙明 卷 宿鹭 ， 天阔 退 飞鸿 。 最羡 鱼竿 客 ， 归船 雨 打篷 。
满庭芳 · 重午 登 栖霞楼L	南宋	王以凝	千古 黄州L ， 雪堂 奇胜 ， 名与 赤壁L 齐高 。 竹楼 千字 ， 笔势 压 江涛 。 笑问 江头 皓月 ， 应 曾照 ， 今古 英豪 。 好在 江山 如画 ， 人 易老 ， 双鬓 难茠 。 升 平代 ， 凭高 望远 ， 当赋 及 离骚 。
黄州L	南宋	陆游	局促 常悲 类 楚囚 ， 迁流 还叹 学 齐优 。 江声 不尽 英雄 恨 ， 天地 无私 草木 秋 。 万里 羁愁 添 白发 ， 一帆 寒日 过 黄州L 。 君看 赤壁L 终 陈迹 ， 生子 何须 似 仲谋P 。
黄州L	南宋	张孝祥	平生 闻 赤壁L ， 今日 到 黄州L 。 古戍 参差 月 ， 空江 浩荡 秋 。 艰难 念 时事 ， 留滞 岂 身谋 。 索索 悲风 里 ， 沧浪 亦 白头 。
游 东坡L 十一绝	南宋	王十朋	再闰 黄州L 正 坐诗 ， 诗因 迁谪 更 瑰奇 。 读公 赤壁词 并赋 ， 如见 周郎P 破贼 时 。
题 徐参议P 赤壁图	南宋	王炎	乌林 赤壁L 事 已陈 ， 黄州L 赤壁L 天下 闻 。 东坡居士P 妙 言语 ， 赋到 此翁 无 古人 。
画 赤壁	宋末元初	赵孟頫	周郎P 赤壁L 走 曹公P ， 万里 江流 斗 两雄 。 苏子P 赋成 奇伟 甚 ， 长教 人想 谪仙P 风 。
登 苏亭L	明	熊桴	五百年 前 苏子P 游 ， 青山 白石 总 风流 。 孤亭 遥隔 金莲 夜 ， 两赋 争传 赤壁L 秋 。 绿柳 红蕖 曾 击楫 ， 沙汀 渔火 漫 停舟 。 乾坤 胜地 容 迁客 ， 应笑 浮云 自 卷收 。
苏子P 游 赤壁L 图	明	何景明	垂老 黄州L 客 ， 高秋 赤壁L 船 。 三分 留 古迹 ， 两赋 到 今传 。 落日 寒江 动 ， 青山 断岸 悬 。 画图 谁 省识 ， 千载 尚 风烟 。
游 赤壁L	明	王世贞	将坛 文苑 代 称雄 ， 指点 千年 感慨 同 。 名在 江山 翻 借色 ， 事过 天地 竟 何功 。
夜泊 赤壁L	明	罗洪先	五百年 来 此胜 游 ， 水光 依旧 接天 浮 。 徘徊 今夜 东山 月 ， 仿佛 当年 壬戌T 秋 。 有客 得鱼 来 赤壁L ， 无人 载酒 出 黄州L 。 吟成 一啸 四山 寂 ， 孤鹤 横江 掠 小舟 。
赤壁L 仙舟 图	明	刘节	仙山 仙水 一 仙舟 ， 锦缆 牙樯 载月 游 。 欲起 东坡 重 作赋 ， 西风 吹梦 落 黄州L 。
赤壁L 怀古	清	朱日濬	江边 一带 起 云烟 ， 峻岭 层岑 仰 昔贤 。 赤壁L 何须 问 出处 ， 东坡 本是 借 山川 。 古来 胜迹 原 无限 ， 不遇 才人 亦 杳然 。 今古 登临 同 此地 ， 风流 未坠 草 芊芊 。
赤壁L	清	刘子壮	赤壁L 千年 古迹 疑 ， 漫劳 过客 访 残碑 。 虽无 一炬 周郎P 烈 ， 却有 三秋 苏子祠P 。 道士 梦中 犹 借鹤 ， 将军 江上 岂 凭龟 。 山川 自为 文人 重 ， 谁起 泉涂 问 是非 。
一剪梅 · 秋夜 偕客 泛舟 赤壁L	清	张维屏	依然 赤壁L 在 黄州L ， 古有 人游 ， 今有 人游 。 茫然 万顷 放 扁舟 ， 人在 中流 ， 月在 中流 。 髯苏 二赋 自 千秋 ， 佳境 长留 ， 佳句 长留 ， 何须 箫管 听 啁啾 ， 诗可 相酬 ， 月可 相酬 。
赤壁L 口号	清	胡绍鼎	周郎P 一炬 破 曹公P ， 如此 勋劳 亦 自雄 。 赤壁L 不知 何处 是 ， 年年 江上 费 春风 。
赤壁L 歌 送别	唐	李白	二龙 争战 决 雌雄 ， 赤壁L 楼船 扫地 空 。 烈火 张天 照 云海 ， 周瑜P 于此 破 曹公P 。 君去 沧江 望 澄碧 ， 鲸鲵 唐突 留 余迹 。 一一 书来 报 故人 ， 我欲 因之 壮 心魄 。
赤壁L 怀古	北宋	苏辙	新破 荆州L 得 水军 ， 鼓行 夏口 气 如云 。 千艘 已共 长江L 险 ， 百胜 安知 赤壁L 焚 。 觜距 方强 要 一斗 ， 君臣 已定 势 三分 。 古来 伐国 须 观衅 ， 忽突 成功 所 未闻 。
满江红 · 赤壁L 怀古	南宋	戴复古	赤壁L 矶头 ， 一番 过 一番 怀古 。 想 当年 周郎P 年少 ， 气吞 区宇 。 马骑 临江 貔虎 噪 ， 千艘 烈 炬鱼 龙怒 。 卷 长波 ， 一鼓 困 曹瞒P ， 今 如许 。
赤壁L	南宋	李壁	赤壁L 危矶 几 度过 ， 沙头 江上 郁 嵯峨L 。 今人 误信 黄州L 是 ， 犹赖 《 水经 》 能 正讹 。
赤壁L 图	金	元好问	马蹄 一蹴 荆门L 空 ， 鼓声 怒与 江流 东 。 曹瞒P 老去 不 解事 ， 误认 孙郎P 作 阿琮P 。 孙郎P 矫矫 人中 龙 ， 顾盼 叱咤 生 云风 。 疾雷 破山 出 大火 ， 旗帜 北卷 天 为红 。 至今 画图 见 赤壁L ， 仿佛 烧虏 留 余踪 。
赤壁L	明	杜庠	水军 南下 本 雄图 ， 千里 长江 隘 舳舻 。 诸葛P 心中 空 有汉 ， 曹瞒P 眼底 已 无吴 。 兵销 巨影 东风 猛 ， 梦断 箫声 夜 月孤 。 过此 不堪 回首 处 ， 荒矶 鸥鸟 满 烟芜 。
赤壁L	唐	杜牧	折戟 沉沙 铁 未销 ， 自将 磨洗 认 前朝 。 东风 不与 周郎P 便 ， 铜雀L 春深 锁 二乔P 。
度 荆门L 望 楚	唐	陈子昂	遥遥 去 巫峡L ， 望望 下 章台L 。 巴国 山川 尽 ， 荆门L 烟雾 开 。 城分 苍野 外 ， 树断 白云 隈 。 今日 狂歌 客 ， 谁知 入楚 来 。
渡 荆门L 送别	唐	李白	渡远 荆门L 外 ， 来从 楚国L 游 。 山随 平野 尽 ， 江入 大荒 流 。 月下 飞天 镜 ， 云生 结 海楼 。 仍怜 故乡 水 ， 万里 送 行舟 。
夷陵城L	唐	胡曾	夷陵L 城阙 依 朝云 ， 战败 秦师 纵火 焚 。 何事 三千 珠 履客 ， 不能 西御 武安君P 。
郢门L 秋怀	唐	李白	郢门L 一 为客 ， 巴月 三 成弦 。 朔风 正 摇落 ， 行子 愁 归旋 。 杳杳 山外 日 ， 茫茫 江上 天 。 终当 游 五湖L ， 濯足 沧浪泉 。
送人 之 荆门L	明	王偁	长江 风飏 布帆 轻 ， 西入 荆门L 感 客情 。 三国 已亡 遗 旧垒 ， 几家 犹在 住 荒城 。
出 峡泊 宜昌府L	清	张问陶	万山 回首 太崚 嶒 ， 此日 余生 问 最能 。 送尽 奇峰 双眼 豁 ， 江天 空阔 看 彝陵L 。
遇微 之 于 峡中	唐	白居易	夷陵L 峡口 明月 夜 ， 此处 逢君 是 偶然 。 一别 五年 方 见面 ， 相携 三宿 未 回船 。 往事 渺茫 都 似梦 ， 旧游 零落 半 归泉 。 未死 会应 相见 在 ， 不知 何地 复 何年 。
系舟 下 牢溪 三游洞L 二十八韵	南宋	陆游	旧观 三峡L 图 ， 常谓 非 人情 。 意疑 天壤 间 ， 岂有 此 峥嵘 。 昨日 到 峡州L ， 所见 始 可惊 。 乃知 画 非妄 ， 却恨 笔 未精 。 峨巍 冠 冕古 ， 阿娜 髻鬟 倾 。 怪怪 与 奇奇 ， 万状 不可 名 。
西陵峡L	唐	杨炯	绝壁 耸 万仞 ， 长波 射 千里 。 盘薄 荆之门L ， 滔滔 南国 纪 。 及余 践 斯地 ， 瑰奇 信 为美 。 江山 若 有灵 ， 千载 伸 知己 。
上 三峡L	唐	李白	巫山L 夹 青云 ， 巴水 流 若兹 。 巴水 忽 可尽 ， 青天 无 到时 。 三朝 上 黄牛 ， 三暮 行 太迟 。 三朝 又 三暮 ， 不觉 鬓 成丝 。
西陵峡L	清	严思濬	夷陵L 形胜 自西 来 ， 此日 登临 亦 快哉 。 山脉 远盘 鹑 尾束 ， 涛声 直撼 峡门 开 。 云连 楚塞 三千里 ， 翠压 江关 十二碚 。 戈戟 消沉 溪水 咽 ， 雄图 几辈 出 群才 。
出峡	宋	苏轼	入峡 喜 巉岩 ， 出峡 爱 平旷 。 闻道 石 最奇 ， 寤寐 见 怪状 。 峡山L 富 奇伟 ， 得一 知几 丧 。 今朝 脱 重险 ， 楚水L 渺 平荡 。
峡口 夜坐	南宋	陆游	三峡L 至此 穷 ， 两壁 犹 峭立 。 风生 树影 动 ， 月碎 水 流急 。 吾行 已 四旬 ， 才抵 楚西邑L 。 浩歌 散 郁陶 ， 还舟 觉 衣湿 。
西陵峡L	清	孙原湘	一滩 声过 一滩 催 ， 一日 舟行 几百回 。 郢树 碧从 帆底 尽 ， 楚台L 青向 橹前 来 。 奔雷 峡断 风 常怒 ， 障日 峰多 雾 不开 。 险绝 正当 奇绝 处 ， 壮游 勿使 客 心哀 。
神鱼	清	程含章	当年 屈子P 投 汨罗L ， 神鱼 衔送 归 桑梓 。 归山 南北 双 崔嵬 ， 忠臣 青冢 丰碑 起 。 神鱼 一岁 一 来游 ， 水静 风平 众 可指 。 我来 杯酒 酬 忠魂 ， 何处 投诗 吊 屈子P 。
楚城	南宋	陆游	江上 荒城 猿鸟 悲 ， 隔江 便是 屈原祠L 。 一千五百 年间 事 ， 只有 滩声 似 旧时 。
归州 重五	南宋	陆游	斗舸 红旗 满 急湍 ， 船窗 睡起 亦 闲看 。 屈平P 乡国 逢 重五 ， 不比 常年 角 黍盘 。
王昭君	唐	李白	汉家 秦地L 月 ， 流影 照 明妃P 。 一上 玉关L 道 ， 天涯 去 不归 。
咏怀 古迹	唐	杜甫	群山 万壑 赴 荆门L ， 生长 明妃P 尚 有村 。 千载 琵琶 作 胡语 ， 分明 怨恨 曲中 论 。
竹枝词 · 昭君村L	唐	李涉	石壁 千重 树 万重 ， 白云 斜掩 碧 芙蓉 。 昭君P 溪上 年年 月 ， 偏照 婵娟P 色 最浓 。
昭君村L	北宋	苏轼	昭君L 本 楚人 ， 艳色 照 江水 。 楚人 不敢 娶 ， 谓是 汉 妃子 。 谁知 去 乡国 ， 万里 为 胡魂 。
哀郢	南宋	陆游	远接 商周 祚 最长 ， 北盟 齐晋 势 争强 。 章华L 歌舞 终 萧瑟 ， 云梦 风烟 旧 莽苍 。 草合 故宫L 惟 雁起 ， 盗穿 荒冢 有 狐藏 。 《 离骚 》 未尽 灵均 恨 ， 志士 千秋 泪 满裳 。
荆州L 歌	唐	李白	白帝城L 边 足 风波 ， 瞿塘L 五月 谁 敢过 。 荆州L 麦熟 茧 成蛾 ， 缫丝 忆君 头绪 多 。 拨谷 飞鸣 妾 奈何 。
九日 龙山L 饮	唐	李白	九日 龙山L 饮 ， 黄花 笑 逐臣 。 醉看 风 落帽 ， 舞爱 月 留人 。
江陵L 望幸	唐	杜甫	雄都L 元 壮丽 ， 望幸 欻 威神 。 地利 西通 蜀 ， 天文 北照 秦 。 风烟 含 越鸟 ， 舟楫 控 吴人 。 未枉 周王P 驾 ， 终期 汉武P 巡 。
咏 楚怀王P	唐	崔道融	宫花 一朵 堂中 开 ， 缓颊 翻为 敌国 媒 。 六里 江山 天下 笑 ， 张仪P 容易 去 还来 。
荆州L	北宋	苏轼	游人 出 三峡L ， 楚地 尽 平川 。 北客 随 南贾 ， 吴樯 间 蜀船 。 江浸 平野 断 ， 风卷 白沙 旋 。 欲问 兴亡 意 ， 重城 自古 坚 。
江陵L 点将台L	清	汤右曾	地形 天险 楚江L 宽 ， 欲借 荆州L 自古 难 。 虚笑 百人 称 武吏 ， 岂同 列郡 领 材官 。
登 九里台L 题 樊姬墓	唐	张说	楚国 所以 霸 ， 樊姬P 有力 焉 。 不怀 沈尹禄P ， 谁进 叔敖P 贤 。 漠漠 渚 宫树 ， 苍苍 云梦 田 。 登高 形 胜出 ， 访古 令 名传 。
纪南 歌	唐	刘禹锡	风烟 纪 南城 ， 尘土 荆门L 路 。 天寒 多 猎骑 ， 走上 樊姬P 墓 。
送 元公P 之 鄂渚L	唐	孟浩然	桃花 春水 涨 ， 元子 忽 乘流 。 岘首 辞 蛟浦 ， 江边 问 鹤楼L 。 赠君 青竹杖 ， 送尔 白苹洲 。 应是 神仙辈 ， 相期 汗 漫游 。
登 襄阳城L	唐	杜审言	旅客 三秋 至 ， 层城 四望 开 。 楚山L 横地 出 ， 汉水L 接 天回 。 冠盖 非 新里 ， 章华 即 旧台 。 习池L 风景 异 ， 归路 满 尘埃 。
汉江L 临泛	唐	王维	楚塞L 三湘L 接 ， 荆门L 九派 通 。 江流 天地 外 ， 山色 有无 中 。 郡邑L 浮 前浦 ， 波澜 动 远空 。 襄阳L 好 风日 ， 留醉 与 山翁P 。
襄阳L 怀古	唐	鲍溶	襄阳L 太守 沉 碑意 ， 身后 身前 几年 事 。 湘江L 千岁 未 为陵 ， 水底 鱼龙 应 识字 。
忆江南 · 襄阳L 好	清	王万芳	襄阳L 好 ， 最好 大堤头L 。 春涨 绿遍 杨柳 岸 ， 晚妆 红映 水边 楼 。 一望 孤帆 收 。
与 诸子 登 岘山L	唐	孟浩然	人事 有 代谢 ， 往来 成 古今 。 江山 留 胜迹 ， 我辈 复 登临 。 水落 鱼梁 浅 ， 天寒 梦泽 深 。 羊公P 碑 尚在 ， 读罢 泪 沾襟 。
襄阳L 曲	唐	李白	岘山L 临 汉江L ， 水绿 沙 如雪 。 上有 堕泪 碑 ， 青苔 久 磨灭 。
忆 襄阳L 旧游 赠 马少府P 巨	唐	李白	高冠 佩 雄剑 ， 长揖 韩荆州P 。 朱颜 君 未老 ， 白发 我 先秋 。 壮志 恐 蹉跎 ， 功名 若 云浮 。 空思 羊叔子P ， 堕泪 岘山 头 。
隆中L	唐	胡曾	世乱 英雄 百战 余 ， 孔明P 方此 乐 耕锄 。 蜀王P 不自 垂 三顾 ， 争得 先生 出 草庐 。
隆中L	北宋	苏轼	诸葛P 来 西国 ， 千年 爱 未衰 。 今朝 游 故里 ， 蜀客 不胜 悲 。 谁言 襄阳L 野 ， 生此 万乘 师 。 山中 有 遗貌 ， 矫矫 龙 之姿 。 龙蟠 山中 秀 ， 龙去 渊潭 移 。 空余 蜿蜒 迹 ， 使我 寒涕 垂 。
过 隆中L	宋	程道融	元德 苍黄 起 卧龙 ， 鼎分 天下 一言 中 。 可怜 蜀国 关张 后 ， 不见 商量 徐庶P 功 。
草庐	明	唐寅	草庐 三顾 屈 英雄 ， 慷慨 南阳L 起 卧龙 。 鼎足 未安 星 又陨 ， 阵图 留与 浪涛 中 。
夜归 鹿门山L 歌	唐	孟浩然	山寺 鸣钟 昼 已昏 ， 渔梁 渡头 争 渡喧 。 人随 沙岸 向 江村 ， 余亦 乘舟 归 鹿门L 。 鹿门L 月照 开 烟树 ， 忽到 庞公P 栖隐 处 。 岩扉 松径 长 寂寥 ， 惟有 幽人 自 来去 。
赠 孟浩然P	唐	李白	吾爱 孟夫子P ， 风流 天下 闻 。 红颜 弃 轩冕 ， 白首 卧 松云 。 醉月 频 中圣 ， 迷花 不事 君 。 高山 安 可仰 ， 徒此 揖 清芬 。
解闷	唐	杜甫	复忆 襄阳L 孟浩然P ， 清诗 句句 尽 堪传 。 即今 耆旧 无 新语 ， 漫钓 槎头 缩 项鳊 。
戏 赠诗	宋	黄庭坚	万里 风帆 水 着天 ， 麝煤 鼠尾 过 年年 。 沧江L 静夜 虹 贯月 ， 定是 米家 书画 船 。
襄阳L 乐	南朝	刘诞	朝发 襄阳城L ， 暮至 大堤L 宿 。 大堤L 诸 女儿 ， 花艳 惊 郎目 。
大堤L 行寄 万七	唐	孟浩然	大堤L 行乐 处 ， 车马 相驰 突 。 岁岁 春草 生 ， 踏青 二三月 。 王孙 挟 珠弹 ， 游女 矜 罗袜 。 携手 今 莫同 ， 江花 为谁 发 。
大堤L 曲	唐	李白	汉水 临 襄阳L ， 花开 大堤L 暖 。 佳期 大堤L 上 ， 泪向 南云 满 。 春风 复 无情 ， 吹我 梦魂 散 。 不见 眼中 人 ， 天长 音信 断 。
南岩宫L	明	章焕	三十六岩 何者 奇 ， 南岩L 岩壑 多 幽姿 。 飞空 欲作 翔鸾 舞 ， 跨涧 真看 渴 虎垂 。 树杪 回栏 时 隐见 ， 云中 栈阁 故 参差 。 归旌 欲问 来时 路 ， 洞口 云深 已 不知 。
晓 登 天柱峰L	明	徐中行	振衣 秋色 散 鸿蒙 ， 绝顶 遥看 万里 空 。 不是 三山 飞海 上 ， 那能 五岳L 聚 天中 。 曜灵 倒射 黄金殿L ， 玄武 高临 赤帝宫L 。 细数 峰峦 三十六 ， 朝来 鳌极 总 相同 。
通羊L 好	北宋	蒋之奇	我爱 通羊L 好 ， 双泉 咫尺 间 。 不须 寻 谢屐 ， 步入 九宫山L 。
寄 九宫山L 提点 车兰谷L	元	虞集	九宫L 山高 白云 深 ， 之子 入山 何处 寻 ？ 清秋 孤鹤 自 致远 ， 大海 苍龙 常在 阴 。 祝侯 解作 禁火 井 ， 赵郎 会鼓 临 风琴 。 怜予 白发 归 最晚 ， 辜负 故人 招隐 心 。
重赠 黄尊师P 菊山	明	宋濂	富川L 山中 黄道士P ， 朝京 年老 出 层林 。 青春 已遂 还乡 愿 ， 白发 优坚 爱 菊心 。 石洞 有牛 留 古迹 ， 丹邱 凭鹤 探 仙音 。 九宫L 自是 云深 处 ， 莫谓 蓬莱 隐 更深 。
西塞山L 怀古	唐	刘禹锡	王濬 楼船 下 益州L ， 金陵L 王气 黯然 收 。 千寻 铁锁 沉 江底 ， 一片 降幡 出 石头 。 人世 几回 伤 往事 ， 山形 依旧 枕 寒流 。 今逢 四海 为 家日 ， 故垒 萧萧 芦 荻秋 。
西塞山L	唐	韦应物	势 从 千里 奔 ， 直入 江中 断 。 岚横 秋塞 雄 ， 地来 惊流 满 。
送 陈郎P 将归 衡阳L	唐	李白	衡山L 苍苍 入 紫冥 ， 下看 南极 老人 星 。 回飙 吹散 五峰 雪 ， 往往 飞花 落 洞庭L 。
望 岳	唐	杜甫	南岳L 配 朱鸟 ， 秩礼 自 百王 。 祝融 五峰L 尊 ， 峰峰 次 低昂 。 慕闻 魏夫人P ， 群仙 夹 翱翔 。 有时 五峰L 气 ， 散风 如 飞箱 。
朱凤 行	唐	杜甫	君 不见 潇湘 之山 衡山L 高 ， 山巅 朱凤 声 嗷嗷 。 侧身 回顾 求 其曹 ， 翅垂 口噤 心 劳劳 。
谒 衡岳庙L 遂 宿 岳寺 题 门楼	唐	韩愈	五岳L 祭秩 皆 三公 ， 四方 环镇 嵩 当中 。 火维 地荒 足 妖怪 ， 天假 神柄 专 其雄 。 喷云 泄雾 藏 半腹 ， 虽有 绝顶 谁 能穷 。 我来 正逢 秋雨 节 ， 天气 晦昧 无 清风 。 潜心 默祷 若 有应 ， 岂非 正直 能 感通 。 须臾 净扫 众峰 出 ， 仰见 突兀 撑 青空 。 紫盖L 连延 接 天柱L ， 石廪L 腾掷 堆 祝融L 。 森然 魄动 下马 拜 ， 松柏 一迳 趋 灵宫 。 夜投 佛寺 上 高阁 ， 星月 掩映 云 膧胧 。 猿啼 钟动 不知 曙 ， 杲杲 寒日 生 于 东 。
游 南岳L	唐	张乔	入岩 仙境 清 ， 行尽 复 重行 。 若得 闲 无事 ， 长来 寄 此生 。 涧松 闲 易老 ， 笼烛 晚生 明 。 一宿 泉声 里 ， 思乡 梦 不成 。
南岳L 绝句	南宋	夏元鼎	崆峒L 访道 至 湘湖L ， 万卷 诗书 看 转愚 。 踏破 铁鞋 无 觅处 ， 得来 全不 费 工夫 。
望 南岳L	元末明初	杨基	我从 匡庐L 来 ， 但觉 诸山 低 。 嵯峨 望 衡岳L ， 云霄 与 之 齐 。 下有 赤蛇 蛰 ， 上有 朱雀 栖 。 仰瞻 祝 融枝 ， 俯揖 紫盖 迷 。
谒 衡山L	明	黄仲芳	衡山L 巨镇 白云 齐 ， 锦绣 峰峦 入望 迷 。 势压 苍梧 知 海近 ， 气吞 星斗 觉 天低 。 箫韶 日下 鸣 丹凤 ， 楼阁 空中 驾 彩霓 。 骢马 同游 穷 胜览 ， 归鞍 不觉 夕阳 西 。
谒 南岳L	明	王伟	巍巍 南岳L 插 晴空 ， 第一 高峰 是 祝融L 。 万里 山河 归 指顾 ， 两轮 日月 界 西东 。 圣灯 夜照 朱陵洞L ， 瑞气 朝连 紫极宫L 。 安得 此身 超 物外 ， 手招 黄鹤 驾 天风 。
游 回雁峰L	清	袁枚	衡郡L 小丹邱 ， 鸣琴 主客 游 。 万家 灯火 上 ， 一曲 楚江L 秋 。 远水 淡 将夕 ， 颓云 凝 不流 。 自怜 人似 雁 ， 到此 亦 回头 。
衡岳L 吟	清	魏源	恒山L 如 行 ， 岱山L 如 坐 ， 华山L 如 立 ， 嵩山L 如 卧 ， 惟有 南岳L 独 如飞 ， 朱鸟 展翅 垂 云大 。 四旁 各展 百十 里 ， 环侍 主峰 如 辅佐 。 云外 之足 万 尘世 ， 云中 之身 万顷 胸 。 大断 大起 大回转 ， 屹然 祝融L 天柱 尊 。 北戒 南戒 岳 各五 ， 衡则 五岭 盟主 人 。 灵均 湘灵 光怪 气 ， 皆是 此山 万古 魂 。
登 祝融峰L	唐	齐已	猿鸟 不 共到 ， 我来 身 欲浮 。 四方 空 碧落 ， 绝顶 正 清秋 。 宇宙 知 何极 ， 华夷 见 细流 。 坛西 独 立久 ， 白日 转 神州 。
祝融峰L	宋	黄庭坚	万丈 祝融L 插 紫霄 ， 路当 穷处 驾 仙桥 。 上观 碧落 星辰 近 ， 下视 红尘 世界 遥 。 螺簇 山低 青 霭霭 ， 线拖 水远 绿 迢迢 。 当门 老桧 枝 已长 ， 绝顶 寒松 叶 不凋 。 龙向 池边 施雨 泽 ， 鸟于 窗外 奏 箫韶 。 游人 未必 常 居此 ， 暂借 禅房 宿 一宵 。
晚泊 湘江L	唐	宋之问	五岭L 凄惶 客 ， 三湘L 憔悴 颜 。 况复 秋雨 霁 ， 表里 见 衡山L 。 路逐 鹏 南转 ， 心依 雁 北还 。 唯余 望 乡泪 ， 更染 竹 成斑 。
湖南L 曲	唐	张籍	潇湘 多 别离 ， 风起 芙蓉洲L 。 江上 人 已远 ， 夕阳 满 中流 。
游 岳麓L 山寺	明	李东阳	危峰 高瞰 楚江 干 ， 路在 羊肠 第几 盘 ？ 万树 松杉 双径 合 ， 四山 风雨 一僧 寒 。 平沙 浅草 连天 远 ， 落日 孤城 隔天 看 。 蓟北L 湘南L 俱 在眼 ， 鹧鸪 声里 独 凭栏 。
翠微亭L	清	赵宁	抱膝 望 湘江L ， 江云 自 舒卷 。 愿将 云 作衣 ， 湘君 为 予 剪 。
书院L 废迹	明	韩阳	峨峨 岳麓山L ， 前贤 读书 处 。 世远 人亦 亡 ， 遗基 尽 荒秽 。 犹存 北海 碑 ， 尚有 南轩 记 。 公暇 亦 来过 ， 徘徊 发 长喟 。
岳麓书院L	明	郭都贤	一幅 清湘 罨画 同 ， 渡江 小艇 载 仙翁 。 深山 大泽 藏文苑 ， 园顶 方袍 谒 圣宫 。 礼乐 诗书 重焕 日 ， 关闽 濂洛 旧 家风 。 莫言 淡薄 难 收拾 ， 数仞 辉煌 逼 大雄 。
到 岳麓书院L	清	旷敏本	朱张 曾此 绛筵 开 ， 犹忆 甘泉 讲学 台 。 岳麓L 于今 真个 到 ， 岂知 畴昔 梦中 来 。
长沙L 过 贾谊宅L	唐	刘长卿	三年 谪宦 此栖 迟 ， 万古 惟留 楚客 悲 。 秋草 独寻 人去 后 ， 寒林 空见 日斜 时 。 汉文 有道 恩 犹薄 ， 湘水L 无情 吊 无知 。 寂寂 江山 摇落 处 ， 怜君 何事 到 天涯 。
渡 青草湖L	南朝	阴铿	洞庭L 春溜 满 ， 平湖 锦帆 张 。 沅水L 桃花 色 ， 湘流L 杜 若香 。 穴去 茅山L 近 ， 江连 巫峡L 长 。 带天 澄 迥碧 ， 映日 动 浮光 。 行舟 逗 远树 ， 度鸟 息 危樯 。 滔滔 不可 测 ， 一苇 讵能 航 ？
望 洞庭湖L 呈 张丞相P	唐	孟浩然	八月T 湖水 平 ， 涵虚 混 太清 。 气蒸 云梦 泽 ， 波撼 岳阳城L 。
晚泊 岳阳L	宋	欧阳修	卧闻 岳阳L 城里 钟 ， 系舟 岳阳L 城下 树 。 正见 空江 明月 来 ， 云水 苍茫 失 江路 。 夜深 江月 弄 清辉 ， 水上 人歌 月下 归 。 一阕 声长 听 不尽 ， 轻舟 短楫 去 如飞 。
临江仙	宋	滕子京	湖水 连天 天连水 ， 秋来 分外 澄清 。 君山 自是 小 蓬瀛 。 气蒸 云梦泽 ， 波撼 岳阳城L 。 帝子 有灵 能 鼓瑟 ， 凄然 依旧 伤情 。 微闻 兰芷 动 芳馨 。 曲终 人 不见 ， 江上 数 峰青 。
与 夏十二P 登 岳阳楼L	唐	李白	楼观 岳阳L 尽 ， 川迥 洞庭L 开 。 雁引 愁心 去 ， 山衔 好月 来 。 云间 逢 下榻 ， 天上 接 行盃 。 醉后 凉风 起 ， 吹人 舞袖 回 。
登 岳阳楼L	唐	杜甫	昔闻 洞庭L 水 ， 今上 岳阳楼L 。 吴楚L 东南 坼 ， 乾坤 日夜 浮 。 亲朋 无 一 字 ， 老病 有 孤舟 。 戎马 关山 北 ， 凭轩 涕泗 流 。
岳阳楼L	唐	李商隐	欲为 平生 一散 愁 ， 洞庭L 湖上 岳阳楼L 。 可怜 万里 堪 乘兴 ， 枉是 蛟龙 解 覆舟 。
省试 湘灵 鼓瑟	唐	钱起	善鼓 云 和 瑟 ， 常闻 帝子 灵 。 冯夷 空 自舞 ， 楚客 不堪 听 。 苦调 凄 金石 ， 清音 入 杳冥 。 苍梧 来 怨慕 ， 白芷 动 芳馨 。 流水 传 湘浦 ， 悲风 过 洞庭L 。 曲终 人 不见 ， 江上 数峰 青 。
望 洞庭L	唐	刘禹锡	湖光 秋月 两 相和 ， 潭面 无风 鉴 似磨 。 遥望 洞庭L 山水色 ， 白银盘 里 一 青螺 。
登楼 望 君山L	清	李旭白	巴陵L 胜概 尽 湖光 ， 一点 君山 绾 夕阳 。 秋入 洞庭L 谁 共醉 ， 隔江 遥忆 酒泉 香 。
桃源L 图	唐	韩愈	嬴P 颠 刘P 蹶 了 不闻 ， 地坼 天分 非所 恤 。 种桃 处处 惟 开化 ， 川原 近远 烝 红霞 。 船开 棹进 一 回顾 ， 万里 苍苍 烟水 暮 。 世俗 宁知 伪 与 真 ， 至今 传者 武陵L 人 。
过 三闾大夫庙L	唐	戴叔伦	沅湘L 流 不尽 ， 屈子P 怨 何 深 。 日暮 秋烟 起 ， 萧萧 枫树林 。
过 百家渡L	南宋	杨万里	柳子祠L 前 春 已残 ， 新晴 特地 却 春寒 。 疏篱 不与 花 为护 ， 只为 蛛丝 作 网竿 。
秋 登 广州城L 南楼	南朝	江总	秋 城 韵 晚笛 ， 危榭 引 清风 。 远气 疑 埋剑L ， 惊禽 似 避弓 。 海树 一边 出 ， 山云 四面 通 。 野火 初烟 细 ， 新月 半轮 空 。 塞外L 离 群客 ， 颜鬓 早 如 蓬 。 徒怀 建邺L 水 ， 复想 洛阳宫L 。 不及 孤飞 雁 ， 独在 上林L 中 。
广州L 王园寺L 伏日 ， 寄 北中 亲友	唐	刘言史	南越L 逢 初伏T ， 东林 度 一朝 。 曲池 煎 畏景 ， 高阁 绝微飙 。 旅恨 生 乌浒L ， 乡心 系 洛桥L 。 谁 怜 在 炎客 ， 一夕 壮容 销 。
题 越王台L	唐	崔子向	越井岗L 头 松柏 老 ， 越王台L 上 生秋草 。 古木 多年 无 子孙 ， 牛羊 践踏 成 官道 。
越井台L 望	唐	刘言史	独立 阳台 望 广州L ， 更 添 羁客 异乡愁 。 晚潮 未至 早潮 落 ， 井邑 暂依 沙上 头 。
中秋 越台L 看月	唐	李群玉	海雨 洗 尘埃 ， 月 从 碧空 来 。 水光 笼 草树 ， 练影 挂 楼台 。 皓耀 迷 鲸目 ， 晶莹 失 蚌胎 。 宵分T 凭栏 望 ， 应合 见 蓬莱L 。
七月十五T 夜 看月	唐	李群玉	朦胧 南溟L 月 ， 汹涌 出 云涛 。 下射 长鲸 眼 ， 遥分 玉兔 毫 。 势来 星斗 动 ， 路越 青冥 高 。 竟夕瞻光彩 ， 昂头 把 白醪 。
净慧寺千佛塔L	南宋	方信孺	九井L 神光 射 斗牛 ， 天 开 宝级 镇 南州L 。 客船 江上 东西 路 ， 常识 嶙峋 云外 浮 。
坡山L 五羊	北宋	郭祥正	番禺 五 仙人 ， 骑羊 各 五色 。 手持 六 秬穗 ， 翱翔 绕 城壁 。 瞥然 乘 云烟 ， 诸羊 化为 石 。 至今 留 空祠 ， 异像 犹 可识 。 曾闻 经猛 火 ， 毫发 无 痕迹 。 五羊 宁 复来 ？ 三说 颇 难测 。 只忧 风雨 至 ， 一朝 随 霹雳 。 君不见 差庐 刘越P 之 洞天 ， 万象 森罗 无 一尺 。
广州L 杂咏	明	汪广洋	石鼎 微薰 茉莉 看 ， 椰瓢 满贮 荔枝 浆 。 木棉 花落 南风 起 ， 五月T 交州L 海气 凉 。
广州L 竹枝	清	王士祯	海珠石L 上 柳阴 浓 ， 队队 龙舟 出浪 中 。 一抹 斜阳 照 金碧 ， 齐 将 孔翠 作 船篷 。 梅花 已近 小春T 开 ， 朱槿 红桃 次第 催 。 杏子 枇杷 都 上市 ， 玉盘 三月T 有 杨梅 。
登 六榕寺L 浮图	清	王士祯	六榕 不 可见 ， 地 以 大苏P 名 。 白社 无人 到 ， 苍苔 满院 生 。 塔 穷 炎海L 目 ， 山 拥 粤王城L 。 欲 假 南溟L 翼 ， 扶摇 詄上 征 。
广州L 荔枝 词	清	屈大均	蓬莱L 一岛 海浮来 ， 上有 离支 下有 梅 。 五色 仙禽 餐 不尽 ， 纷纷 衔过 粤王台L 。 神农P 本草 未曾 知 ， 绝代容华 过岭迟 。 一自 汉宫 扶荔筑 ， 尽 惊 南海L 有 琼枝 。
木棉花 歌	清	陈恭尹	粤江L 二月T 三月T 来 ， 千树 万树 朱华 开 。 有如 尧时T 十日 出 沧海 ， 又似 魏宫 万炬 环 高台 。 覆 之 如 铃 仰 如 爵 ， 赤瓣 熊熊 星 有角 。 后出 棠榴 枉 有名 ， 同时 桃杏 惭 轻薄 。 岁岁年年 五岭L 间 ， 北人 无路 望 朱颜 。 愿为 飞絮 衣 天下 ， 不道 边风 朔雪 寒 。
浴日亭	宋	苏轼	剑气 峥嵘 夜 插天 ， 瑞光 明灭 到 黄湾L 。 坐看 旸谷 浮 金晕 ， 遥想 钱塘L 涌 雪山 。 已觉 苍凉 苏 病骨 ， 更烦 沆瀣 洗 衰颜 。 忽 惊 鸟 动 行人 起 ， 飞上 千峰 紫翠 间 。
南海L 东庙 浴日亭	宋	杨万里	南海L 端为 四海 魁 ， 扶胥 绝境 信 奇 哉 。 日 从 若木 梢头 转 ， 潮 到 占城L 国里 回 。 最爱 五更T 红浪 沸 ， 忽吹 万里 紫霞 开 。 天公 管领 诗人 眼 ， 银汉 星槎 借 一 来 。
浴日亭	清	潘耒	孤亭 临望 尽 重溟 ， 天水 相摩 不断 青 。 日跃 半洋 皆 紫电 ， 潮来 大地 一 浮萍 。 鹏游 世界 原 空阔 ， 蜃 吐 楼台 自 杳冥 。 何必 褰裳 慕蓬岛L ， 当知 此地 即 珠庭 。
春日 登 粤王台	清	陈恭尹	花发 高台 磴道 遥 ， 粤王P 曾 此 拜 中朝 。 谁 云 七郡 初 归汉 ， 古者 南交L 已 宅尧 。 江势 急流 宗 渤澥 ， 山光 相望 忆 箫韶 。 炎州L 文物 从来 事 ， 霸气 千年 倍 寂寥 。
珠江L 春 泛作	清	屈大均	珠水L 烟波 接海 长 ， 春潮 微带 落霞 光 。 黄鱼 日 作 三江L 雨 ， 白鹭 天 留 一片 霜 。 洲 爱 琵琶 风外 语 ， 沙怜 茉莉 月 中 香 。 斑枝 况 复 红 无数 ， 一棹 依依 此 夕阳 。
珠江L 杂咏	清	胡会恩	我 爱 珠江L 好 ， 风光 入岭 偏 。 帆 飞 蝌蚪 水 ， 杖 倚 鹧鸪 天 。 穗石 仙踪 古 ， 花田 粉泽 妍 。 扶胥L 望不及 ， 身 在 海云边 。
镇海楼L	明	李时行	缥缈 飞楼 高 接天 ， 窗 临 星斗 望 中 悬 。 浮空 雪浪 三江L 口 ， 映树 晴霞 五岭L 前 。 草长 越台 连 野色 ， 花深 药圃L 暗 春烟 。 倚栏 极北L 频 回首 ， 遥指 长安L 在 日边 。
重阳T 前一日 登 镇海楼L	清	王摅	无端 来作 五羊L 游 ， 节近 登高 上 此楼 。 海气 溟濛 山 绕 郭 ， 天风 浩荡 客 悲秋 。 飘荡 且 喜 云生 屐 ， 簪菊 应 羞 雪 满头 。 乡国 茫茫 何处 是 ， 珠江L 一片 夕阳 愁 。
九日 登 镇海楼L	清	陈恭尹	清尊 须 醉 曲栏 前 ， 飞阁L 临秋 一 浩然 。 五岭L 北来 峰 在地 ， 九州L 南尽 水 浮天 。 将开 菊蕊 黄 如 酒 ， 欲 到 松风 响 似 泉 。 白首 重阳T 惟 有笑 ， 未堪 怀古 问 山川 。
登 镇海楼L	清	沈元沧	凌虚 百尺 倚 危楼 ， 似 入 仙台 足 胜游 。 半壁 玉山L 依 槛峙 ， 一泓 珠海L 抱 城流 。 沙洲 漠漠 波涛 静 ， 瓦屋 鳞鳞 烟火 稠 。 黄气 紫云 消歇 尽 ， 还凭 生聚 壮 炎州L 。
登 蒲涧寺L 后 二岩 三首 其三	唐	李群玉	南溟L 吞 越绝 ， 极望 碧 鸿濛 。 龙渡 潮声 里 ， 雷喧 雨气 中 。 赵佗P 丘垄 灭 ， 马援 鼓鼙 空 。 遐想 鱼鹏化 ， 开襟 九万风 。
广州L 蒲涧寺L	宋	苏轼	不用 山僧 导 我 前 ， 自寻 云外 出 山泉 。 千章 古木 临 无地 ， 百尺 飞涛 泻漏天 。 昔日T 菖蒲 方士宅 ， 后来 薝卜 祖师禅 。 而今 只有 花 含笑 ， 笑道 秦皇P 欲 学仙 。
饮虹桥L	清	杭世骏	飞泉 百道 落长 空 ， 俯饮 时来 五色 虹 。 金晕 有光 侵 晓日 ， 石梁 无语 卧 秋风 。 岸边 苦竹 青 辞箨 ， 涧底 香蒲 细 茁丛 。 凭仗 短藤 闲 徙倚 ， 乱流 寒送 水 丁冬 。
九龙泉L	清	杭世骏	鳞甲 纷纷 逐 赭鞭 ， 濂泉L 上有 九龙泉L 。 蜿蜒 互洒 浇 花雨 ， 踯躅 分耕 种 秫烟 。 怒挟 疾风 穿壁 去 ， 懒贪 明月 抱珠 眠 。 山僧 洗钵 频 来往 ， 照见 条衣 瘦影 偏 。
题 大庾岭L 北驿	唐	宋之问	阴月T 南飞 雁 ， 传闻 至此 回 。 我 行 殊未已 ， 何日 复 归来 。 江静 潮 初落 ， 林昏 瘴 不开 。 明朝 望 乡处 ， 愁见 陇头 梅 。
南安军L	南宋	文天祥	梅花 南北 路 ， 风雨 湿 征衣 。 出岭 同 谁 出 ， 归乡 如此 归 。 山河 千古 在 ， 城郭 一时 非 。 饥死 真 吾爱 ， 梦中 行 采薇 。
度 梅岭L 其一	明	戚继光	溪流 百折 绕 青山 ， 短发 秋风 夕照 间 。 身入 玉门L 犹 是 梦 ， 复 从 天末 出 梅关L 。
度 梅岭L 其二	明	戚继光	北去 南来 已 白头 ， 逢人 莫话 旧时 愁 。 空余 庾岭L 关前 月 ， 犹照 渔阳L 塞外 秋 。
秋 发 庾岭L	明	汤显祖	枫叶 沾 秋影 ， 凉蝉 隐 夕晖 。 梧云 初 晻霭 ， 花露 欲 霏微 。 岭色 随行 棹 ， 江花 满 客衣 。 徘徊 今夜 月 ， 孤鹊 正 南飞 。
梅岭L	清	杭世骏	绝险 谁 教 一线通 ， 雄关 横截 岭西 东 。 搀天 路迥 盘蛇 细 ， 拔地 峰奇 去雁 空 。 戍草 乱侵 萧渤垒L ， 阵云 遥堕 尉佗宫L 。 荒祠L 一拜 张丞相P ， 疏凿 真能 迈 禹P 功 。
度 梅岭L	清	张衍懿	拔起 危峰L 万仞 雄 ， 势临 百粤 控 南中 。 人 从 丹壁 千盘 上 ， 路入 青天 一箭 通 。 古碣 尚留 唐相P 迹 ， 荒祠 谁记 越王P 功 ？ 只今 四海 梯航 日 ， 早见 征车 度 晓风 。
度 大庾岭L	清	朱彝尊	雄关 直上 岭云 孤 ， 驿路 梅花 岁月 徂 。 丞相P 祠堂 虚 寂寞 ， 越王P 城阙 总 荒芜 。 自来 北至 无 鸿雁 ， 从此 南飞 有 鹧鸪 。 乡国 不堪 重 伫望 ， 乱山 落日 满 长途 。
题 罗浮山L	南朝	阴铿	罗浮L 银是殿 ， 瀛洲L 玉为堂 。 朝游 云 渐起 ， 夕饵 菊 恒 香 。 聊 持 履 成 燕 ， 戏 以 石 为 羊 。 洪崖P 与 松子P ， 乘羽 就 周王P 。
食 荔枝	宋	苏轼	罗浮山L 下 四时 春 ， 卢橘 杨梅 次第 新 。 日 啖 荔枝 三百颗 ， 不辞 长作 岭南L 人 。
白水山L 佛迹岩	宋	苏轼	何人 守 蓬莱L ， 夜半 失 左股L ？ 浮山L 若 鹏蹲 ， 忽展 垂 天羽 。 根株 若 连络 ， 崖峤 争 吞吐 。 神工 自 炉鞲 ， 融液 相 缀补 。 至今 余隙 罅 ， 流出 千斛 乳 。 方其 欲 合时 ， 夭匠 麾 月斧 。
罗浮山L 行	宋	祖无择	昔年 潘阆P 倒 骑驴 ， 为爱 三峰 插 太虚 。 我 到 罗浮L 看不足 ， 下山 还解 倒肩舆 。
游 罗浮L	明	湛若水	闻歌 一夜 动 幽怀 ， 直踏 飞云 万丈 崖 。 翠霭 浮云 白日 暝 ， 虹桥 有路 青天 来 。 三月T 二月T 春 之 半 ， 千山 万山 花 正 开 。 笑问 仙源 杳 何许 ， 云涛 浩浩 不堪 裁 。
望 罗浮L	清	翁方纲	篷窗 集 金石 ， 著录 又 三年 。 未得 斯 深入 ， 编摩 意 阙然 。 苔名 丹灶 底 ， 云篆 铁桥 边 。 不晓 山灵 意 ， 终封 抑 肯 传 。
宿 冲虚观L	清	陈恭尹	碧削 群峰 列 四垣 ， 仙宫 高坐 不知 寒 。 春前 萤火 明 丹灶 ， 夜静 流星 落 斗坛 。 几穴 雕梁 巢 白蚁 ， 一家 衰草 住 黄冠 。 山尊 对语 梅花 下 ， 福地L 而今 路 亦 难 。
题 七星岩L	清	全祖望	七星岩L 里 花蝙蝠 ， 五色迷人 双目 睛 。 不减 罗浮L 大蝴蝶 ， 仙风习习 更 通灵 。
沥湖 舟泛	清	屈大均	峰势 盘回 北斗 同 ， 沥湖L 应与 绛河L 通 。 兰桡 曲曲 穿 岩口 ， 石乳 泠泠 滴 镜中 。 雁影 尚留 炎海 雪 ， 莺声 不待 落梅 风 。 芙蓉 只解 窥 渔父 ， 苍翠 沾衣 影 似 空 。
鼎湖L 白云寺L	明	憨山	苍梧 西望 鼎湖L 东 ， 黄帝P 飞升 湖 已空 。 环佩 自 归 金阙 后 ， 仙灵 常在 白云 中 。 青山 地拥 莲花藏 ， 绀殿 天开 释梵宫 。 依仗 独依 空界 立 ， 侧身 恍惚 御冷风 。
游 西樵山L 左转 三里 至 逍遥 石下	清	袁枚	冒雨 游 西樵L ， 为 访 白云洞L 。 渡过 两 危桥 ， 逼仄 不容 鞚 。 将身 学 蝼蚁 ， 迂曲 穿 石缝 。 绝壁 飞泉 奔 ， 激怒 声 如 洪 。 其下 凿 曲池 ， 流觞 借 水 送 。 磨崖 字 纷纷 ， 前明T 游者 众 。 左转 尤 奇绝 ， 逍遥石 可弄 。 万牛 撵不前 ， 两手 推 可动 。 安得 秤 象船 ， 一试 石 轻重 。
游 西樵山L 六首 其二	清	丘逢甲	樵山L 七二 峰 ， 樵湖L 廿八 曲 。 斜阳 棹歌 起 ， 湖光 荡山 绿 。 群峰 万 紫翠 ， 毕入 湖 人目 。 湖 转 山 益 深 ， 悬 蹬 出 林麓 。 云际 闻 鸡鸣 ， 知 有 山人 屋 。
江月 五首之一 · 与客 游 丰湖L	宋	苏轼	一更 山 吐月 ， 玉塔L 卧 微澜 。 正似 西湖L 上 ， 涌金门L 外 看 。 冰轮 横 海阔 ， 香雾 入 栈寒 。 停鞭 且 莫去 ， 照 我 一杯 残 。
西湖L 春晓	宋	黎应时	西湖L 春半 晓 山青 ， 四望 春光 入 画屏 。 荔浦L 枝头 犹 挂月 ， 菱湖L 波底 尚 涵星 。 莺啼 弱柳 浑 藏影 ， 塔起 扶桑 始 著形 。 蜒艇 微茫 中 菡萏 ， 一声 欸乃 破 苍冥 。
丰湖L	南宋	刘克庄	岷峨一老P 古来 少 ， 杭颖二湖L 天下 无 。 帝 恐 先生 晚 寥落 ， 南迁 犹得 管 丰湖L 。
惠州L	清	李黻平	回首 罗阳L 落照 残 ， 萧晨 风物 尽相 看 。 烟迷 鹤观L 荒荒碧 ， 水抱 鹅城L 淰淰寒 。 万古 文章 雄 海外 ， 一生 事业 在 江干 。 停舟 无限 遭逢 感 ， 也拟 林婆P 酒盏 乾 。
点翠洲L	明	孔少娥	西湖L 西子 两 相俦 ， 湖面 偏宜 点翠洲L 。
西湖L 吊 朝云墓L 其四	清	丘逢甲	何年 云雨 散 巫阳 ， 瘴雾 沉埋 玉骨 凉 ？ 合种 梅花 三百树 ， 六如亭畔L 护 遗香 。
小西湖L 棹歌 其一	清	宋湘	东江L 水长 西江L 落 ， 南堤 北堤 有 水关 。 生长 西湖L 撑 艇子 ， 不愁 风浪 只愁 闲 。
小西湖L 棹歌 其二	清	宋湘	西新桥L 下 水苏苏 ， 三月T 风吹 白饭鱼 。 郎罩 桥南 妾 桥北 ， 两头 莫放 一头 虚 。
小西湖L 棹歌 其三	清	宋湘	小米侍郎P 生 较晚 ， 龙眠居士P 远 难呼 。 为知 若个 丹青手 ， 能写 微澜玉塔图 。
惠州L 小西湖L 棹歌	清	江逢辰	菜花 开时 胡蝶 飞 ， 菜心 摘时 儿臂 肥 。 黄塘L 井水 甜 于 蜜 ， 贪饮 清泉 不肯 归 。
崖门L 吊古	明	梁有誉	谁悟 当年 谶 已真 ， 汴杭L 回首 总 成尘 。 愤 无 勾践P 三千 士 ， 死恨 田横P 五百 人 。 海上 乾坤 春梦 短 ， 崖前 风雨 国仇 新 。 魂 若作 啼鹃 去 ， 葛岭L 峰头 哭 万巡 。
崖门L 吊古	明	陈邦彦	往事 苍茫 不 可寻 ， 东风 吹雨 昼 阴阴 。 精魂 拟共 湘波 怨 ， 遗恨 长留 越客 吟 。 赖是 圣明P 回 汉甸 ， 只今 邦计 仗 南琛 。 舂陵L 佳气 中兴 日 ， 借取 当年 义士 心 。
过 零丁洋L	宋	文天祥	辛苦 遭逢 起 一经 ， 干戈 寥落 四周 星 。 山河 破碎 风 抛絮 ， 身世 飘落 雨 打萍 。 惶恐滩L 头 说 惶恐 ， 零丁洋L 里 叹 零丁 。 人生 自古 谁 无死 ， 留取 丹心 照 汗青 。
滕王阁 序	唐	王勃	老当 益壮 ， 宁移 白首 之 心 ？ 穷 且 益坚 ， 不坠 青云 之 志 。 酌 贪泉L 而 觉爽 ， 处 涸辙 以 犹欢 。
广府L 胡尚书P 频 寄诗 因答 绝句	唐	白居易	尚书L 清白 临 南海L ， 虽饮 贪泉L 心 不回 。
寄 迁客	唐	张祜	万里 南迁 客 ， 辛勤 岭路 遥 。 溪行 防 水弩 ， 野店 避 山魈 。 瘴海L 须求 药 ， 贪泉L 莫 举瓢 。 但 能 坚 志义 ， 白日 甚 昭昭 。
贬 崖州L 司户 道中	唐	李德裕	岭水 争分 路 转迷 ， 桄榔 椰叶 暗 蛮溪 。 愁冲 毒雾 逢 蛇草 ， 畏落 沙虫 避 燕泥 。 五月T 畬田 收 火米 ， 三更T 津吏 报 潮鸡 。 不堪 肠断 思乡 处 ， 红槿 花中 越鸟 啼 。
登 崖州城L 作	唐	李德裕	独上 高楼 望 帝京L ， 鸟飞 犹是 半年 程 。 青山 似欲 留人 住 ， 百匝 千回 绕 郡城L 。
行琼 、 儋间 ， 肩舆 坐睡 。 梦中 得句 云 ： 千山 动 鳞甲 ， 万谷 酣 笙钟 。 觉而 遇 清风 急雨 ， 戏作 此 数句	宋	苏轼	四州L 环 一岛 ， 百洞 蟠 其中 。 我 行 西北 隅 ， 如 渡 月半 弓 。 眇观 大瀛海 ， 坐咏 谈天翁P 。 茫茫 太仓 中 ， 一米 谁 雌雄 。 幽怀 忽 破散 ， 永啸 来 天风 。 千山 动 鳞甲 ， 万谷 酣 笙钟 。 安知 非 群仙 ， 钧天 宴 未终 。 久矣 此 妙声 ， 不闻 蓬莱宫L 。
吾 谪 海南L ， 子 由 雷州L ， 被命 即行 ， 了不 相知 ， 至梧 乃 闻 其 尚在 藤 也 ， 旦夕 当 追及 ， 作 此诗 ， 示之	宋	苏轼	江边 父老 能 说子 ： “ 白须 红颊 如 君 长 。 ” 莫嫌 琼雷L  隔 云海 ， 圣恩 尚许 遥 相望 。 天 其 以 我 为 箕子 ， 欲使 此意 留 要荒 。 他年 谁作 舆地 志 ， 海南L 万里 真 吾乡 。
澄迈驿L 通潮阁L	宋	苏轼	余生 欲老 海南村L ， 帝遣 巫阳 招 我魂 。 杳杳 天低 鹘 没处 ， 青山 一发 是 中原L 。
初至 崖州L 吃 荔枝	宋	惠洪	口腹 平生 厌 事治 ， 上林 珍果 亦 尝之 。 天公 见我 流涎 甚 ， 遣向 崖州L 吃 荔枝 。
琼台L	宋	李光	玉台 孤耸 出 尘寰 ， 碧瓦 朱甍 缥缈 间 。 爽气 遥通 天际 月 ， 沧波 不隔 海中山L 。 潮平 贾客 连樯 至 ， 日晚 耕牛 带犊 还 。 安得 此身 生 羽翼 ， 便 乘风 驭 叩 天关 。
寄 参政 李光P	宋	胡铨	海风 飘荡 水云 飞 ， 黎婺山L 高 日上 迟 。 千里 孤身 一壶 酒 ， 此情 惟有 故人 知 。
琼州L 出郭	元	范椁	自出 琼州L 古郭门 ， 更无 平衍L 似 中原L 。 重重 叶暗 桄榔 雨 ， 知是 黎人 第几村 ？
渡海	清	孙元衡	捩舵 扬帆 似 发机 ， 茫洋 自顾 此生 微 。 乱山 断处 天 应尽 ， 一发 穷时 鸟 不飞 。 鱼眼 光边 波 闪烁 ， 龙涎 影外 国 依稀 。 壮游 奇绝 平生 冠 ， 斯语 东坡P 未必 非 。
五指 参天	明	丘濬	五峰 如指 翠 相连 ， 撑起 炎荒L 半壁 天 。 夜盥 银河 摘 星斗 ， 朝探 碧落 弄 云烟 。 雨余 玉笋 空中 现 ， 月出 明珠 掌上 悬 。 岂是 巨灵 伸 一 臂 ， 遥从 海外 数 中原L 。
被酒 独行 ， 遍至 子云P 、 威P 、 徽P 、 先觉P 四黎 之 舍 （ 三首之一 ）	宋	苏轼	半醒 半醉 问 诸黎 ， 竹刺 藤梢 步步 迷 。 但寻 牛矢 觅 归路 ， 家 在 牛栏L 西 复 西 。
登载 酒堂 其二	宋	杨万里	东坡P 无地 顿 危身 ， 天赐 黎山L 活 逐臣 。 万里 鲸波 隔 希奭P ， 千年 桂酒 吊 灵均P 。 精忠 塞得 乾坤 破 ， 日月 伴渠 文字 新 。 祇个 短檐 高屋 帽 ， 青莲居士P 谪 仙人 。
登载 酒堂 其一	宋	杨万里	先生 初落 海南L 垂 ， 茅屋 三间 不到 伊 。 更有 高堂 悬 画像 ， 幸无 过客 首 新诗 。 古来 贤圣 皆 如此 ， 身后 功名 属 阿 谁 。 底事 百年 谭太守P ， 却教 宾主 不 同时 。
琼山L	明	丘濬	环海 三千里 ， 珠崖L 第一山 。 名驰 四海 内 ， 秀出 万峰 间 。 月下 森 瑶简 ， 风前 振 佩环 。 孤高 犹 润泽 ， 蜡屐 未容 攀 。
琼山L 春晓	明	丘濬	缥缈 波涛 四望 中 ， 春光 晓色 四时 同 。 云开 若木 天头 白 ， 水击 扶桑 日脚 红 。 海岛L 三千余 里地 ， 花朝T 二十四 番风 。 阳春T 有脚 行 初到 ， 和气 融融 满 太空 。
送 桂州L 严大夫	唐	韩愈	苍苍 森 八桂 ， 兹地 在 湘南L 。 江作 青罗带 ， 山 如 碧玉簪 。 户多 输 翠羽 ， 家 自种 黄柑 。 远胜 登仙 去 ， 飞鸾 不暇 骖 。
寄 杨五P 桂州L 谭	唐	杜甫	五岭L 皆 炎热 ， 宜人 独 桂林L 。 梅花 万里 外 ， 雪片 一冬 深 。 闻 此 宽 相忆 ， 为邦 复 好音 。 江边 送 孙楚P ， 远附 白头 吟 。
桂林L	唐	李商隐	城窄 山 将压 ， 江宽 地 共浮 。 东南L 通 绝域 ， 西北L 有 高楼 。 神护 青枫岸 ， 龙移 白石湫L 。 殊 乡 竟 何 祷 ， 箫鼓 不曾 休 。
寄 桂府 杨中丞P	唐	赵嘏	遥闻 桂水L 绕 城隅 ， 城上 江山 满 画图 ， 为问 訾家洲L 畔月 ， 清秋T 拟许 醉狂 无 。
寄 阳朔L 友人	唐	曹邺	桂林L 须产 千株 桂 ， 未解 当天 影日 开 。 我到 月中 收得 种 ， 为君 移向 故园 栽 。
过 桂州L	唐	黄庭坚	桂岭L 环城 如 雁荡L ， 平地 苍玉 忽 嶒峨 。 李成P 不在 郭熙P 死 ， 奈此 百嶂 千峰 何 。
喜雪 示 桂人	宋	范成大	腊雪 同云 岭外L 稀 ， 南人 北客 尽 冬衣 。 从今 老杜P 诗 犹 信 ， 梅片 飞时 雪 也 飞 。
桂林L 道中	宋	李纲	桂林L 山水 久 闻风 ， 身世 茫然 堕 此中 。 雁荡L 武彝L 何 足 道 ， 千岩 元是 小玲珑 。
题 静江L	宋	陈藻	桂林L 多 洞府 ， 疑是 馆 群仙 。 四野 皆 平地 ， 千峰 直 上天 。
灵川县L 观 桂林山L	宋	陈孚	碧波 洗出 万 云鬟 ， 堆满 残阳 紫翠 间 。 三世 眼根 修 得到 ， 天教 尽见 桂州山L 。
桂林L 山水歌	清	俞廷举	桂林L 山水 天下 无 ， 青罗 碧玉 色色 殊 。 突兀 一峰 冲 天衢 ， 万笏 千笋 平空 铺 。 百川 到底 如 明珠 ， 无人 会写 真形 图 。 个中 知者 其 谁 乎 ， 前有 昌黎P 后 石湖P 。
桂江L	唐	曹松	未识 佳人 寻 桂水L ， 水云 先 解傍 壶觞 。 笋林 次第 添 斑竹 ， 雏鸟 参差 护 锦囊 。 洞乳 此时 连 越井 ， 石楼 何日 到 仙乡 ？ 如飞 似 堕 皆 青壁 ， 画手 不如 元化 强 。
桂水L 歌	明	解缙	广西L 下来 滩 复 滩 ， 三百六十 长 短 湾 。 潭心 绿水 缓悠悠 ， 长湾 短湾 凝 不流 。 涓涓 千尺 澄 见底 ， 隔江 穿行 鱼 曳尾 。 忽然 路绝 山势 回 ， 峡石 水深 如 怒雷 。
漓江 舟行	明	俞安期	桂楫 轻舟 下 粤关 ， 谁言 岭外 客行 艰 ？ 高眠 翻爱 漓江L 路 ， 枕底 涛声 枕上 山 。
由 桂林L 朔 漓江L 至 兴安L	清	袁枚	江到 兴安L 水 最清 ， 青山 簇簇 水中 生 。 分明 看见 青山 顶 ， 船 在 青山 顶上 行 。
桂江L 舟行 口号 其一	清	查慎行	漓江L 江色 绿 于 油 ， 百折千回 到 海休 。 多事 天公 三日 雨 ， 一条 罗带 变 黄流 。
桂江L 舟行 口号 其三	清	查慎行	戍旗 相傍 有 人家 ， 水退 依然 就 浅沙 。 二月T 芳菲 春 已盛 ， 满滩 芦菔 自 开花 。
伏波L 晓棹	明	彭而述	伏波山L 下 系 江船 ， 画角 钟声 破 晓烟 。 无数 青山 浮水 出 ， 中流 夜雨 带 帆悬 。 惊残 龙梦 愁 珠 去 ， 直踏 蛟宫 泛斗 还 。 最是 无情 分水岭L ， 一时 南北 鼓阗阗 。
米公P 遗像 赞	元	倪瓒	米宫P 遗像 刻 坚珉 ， 犹在 荒城L 野水滨L 。 绝叹 莓苔 迷 惨淡 ， 细看 风骨 尚 嶙峋 。
还珠洞L	宋	方信孺	归舟 多载 小 江春 ， 重访 东岩L 旧屐 痕 。 插水 峭崖 犹 有路 ， 垂天 怪石 本 无根 。 金华L 仙伯 真 知已 ， 薏苡将军P 足 断魂 。 安得 北山公P 可作 ， 倩渠 移取 向 家园 。
独秀山L	唐	张固	孤峰 不与 众山 俦 ， 直入 青云 势 未休 。 会 得 乾坤 融结 意 ， 擎天 一柱 在 南州L 。
登 独秀峰L	清	袁枚	来龙去脉 绝无 有 ， 突然 一峰 插 南斗 。 桂林L 山形 奇 八九 ， 独秀峰L 尤 冠 其 首 。 三百六级 登 其 巅 ， 一城 烟火 来 眼前 。 青山 尚且 直 如 弦 ， 人生 孤立 何伤 焉 ？
访 叠彩岩L 登 越亭L	宋	朱晞颜	不到 越亭L 久 ， 榴花 今 几红 。 江流 寒 泻玉 ， 山色 翠 浮空 。 百越L 薰风 里 ， 三湘L 夕照 中 。 行藏 仗 忠信 ， 六合 本 同风 。
登 叠彩山L	明	刘台	嵯峨 怪石 倚 云间 ， 洞锁 烟霞 六月T 寒 。 我 到 登临 花 正好 ， 凭栏 指点 几回 看 。
风洞山L 吊古	清	施彰文	古洞 穿 山腹 ， 天风 六月T 寒 。 危栏 凭 树杪 ， 飞阁 耸 云端 。 智勇 五年 竭 ， 山河 半壁 残 。 岩前 双 烈士 ， 热血 几曾 干 。
同 张雪川P 登 叠彩山风洞L	清	李秉礼	漓江L 下瞰 净 如 练 ， 水底 倒插 青 芙蓉 。 红树 人家 秋瑟瑟 ， 夕阳 台榭 烟濛濛 。 座中 起舞 属 佳客 ， 天际 遗音 送去 鸿 。 欲 乞 洞中 一片 石 ， 为 传 此意 留 无穷 。
风洞L 题壁	清	陈长生	奇石 嵯峨 古渡头L ， 訾洲L 红叶 桂林L 秋 。 洞中 穿过 高楼 望 ， 人 在 荆关P 画里 游 。
游 七星岩L	明	解缙	早饭 行春 桂水L 东 ， 野花 榕叶 露 重重 。 七星岩窟L 篝灯 入 ， 百转 萦回 路径 通 。 石溜 滴余 成 物象 ， 古潭 深处 有 蛟龙 。 却归 为 恐衣 沾湿 ， 洞口 云深 日 正中 。
西江月 · 栖霞洞L	南宋	梁安世	南国L 秋光过二T ， 宾鸿 未带 初寒 。 洞中 驼褐 已 嫌 单 ， 洞口 犹须 挥扇 。 夕照 千峰 互见 ， 晴空 万象 都还 。 羡 它 渔艇 系 澄湾 ， 欹枕 玻璃 一片 。
栖霞洞L	清	朱凤森	我爱 栖霞洞L ， 溪流 玉 带环 。 江云 千里 日 ， 萝月 七星山L 。 石乳 悬 香雪 ， 仙床 拥 翠鬟 。 探 奇峰 万矗 ， 直到 九疑弯L 。
象鼻山L	明	孔镛	象鼻L 分明 饮 玉河L ， 西风 一吸 水 应 波 。 青山 自是 饶 奇骨 ， 白日 相看 不厌 多 。
水月洞L	宋	张自明	癸水L 江头 石 似 浮 ， 银河 影里 月 如钩 。 无人 弄杵 看 蟾兔 ， 有客 乘槎 访 斗牛 。 自古 鹊桥 传 七日 ， 何年 桂子 落 三秋T 。 金轮 欲 待 长 无缺 ， 玉斧 仍须 妙手 修 。
象鼻山L	明	卢仲佃	巃嵸 天象 出 云端 ， 战住 人间 活水滩L 。 饱吸 清风 高卷 鼻 ， 横托 明月 懒 归阑 。 空中 体格 三更 白 ， 物外 烟霞 六月T 寒 。 坐久 洞中 尘世 隔 ， 冰壶 玉宇L 意中 看 。
穿山月岩L	宋	胡仲威	石磴 𡼭嵚 几许 层 ？ 坐来 心迹 自 双清 。 不知 浑沌 何年 凿 ， 便有 婵娟 一镜 明 。 周穆P 马蹄 何 寂寞 ， 谢公P 屐齿 欠 安平 。 飘然 欲御 长风 去 ， 冉冉 烟云 脚底 生 。
游 龙隐洞L	宋	朱晞颜	翠壁 峥嵘 百仞 雄 ， 玉龙 飞下 水晶宫 。 禹门L 激浪 纵 三级 ， 越峤L 眼云 仅 一弓 。 银阙 交辉 天 不夜 ， 全鳞 倒影 水 浮空 。 卷怀 霖雨 沈潜 久 ， 会 有 惊雷 适 岁丰 。
龙隐洞L	清	陈元龙	看山 如 观画 ， 游山 如 读史 。 桂州L 岩穴 奇 ， 石刻 穷 秘诡 。 龙隐 一 拳石 ， 耸倚 江 之 沚 。 中有 元祐碑 ， 所谓 党人 是 。 三百 有 九人 ， 一一 皆 君子 。 宋史 或 未详 ， 兹焉 炳 名氏 。
留别 隐山L	唐	李渤	如云 不厌 苍梧L 远 ， 似雁 逢春 又 北归 。 惟有 隐山L 溪上 月 ， 年年 相望 两 依依 。
晦日T 游 隐山L	明	张鸣凤	节晦 前朝 重 ， 春山 胜事 多 。 岩虚 浑 驾木 ， 石长 半 凌波 。 日影 惊 鱼跃 ， 泉声 答 鸟歌 。 韦吴P 碑 在否 ， 不惜 更 摩挲 。
游 隐山L 诸洞	清	张祥河	城西 三里 路 庚庚 ， 蝙蝠 飞斜 夕照 迎 。 李渤P 开榛 峰 屈曲 ， 贯休P 画佛 墨 纵横 。 青牛 稳跨 双矶 坐 ， 白雀 争传 六洞名 。 当日 西湖L 移棹 去 ， 至今 剩有 勺泉 清 。
醉太平 忆 隐山L 六洞	清	王鹏运	惊云 势偏 ， 流霞 态妍 ， 一壶 岚翠 苍然 ， 乍 家山 眼前 。 湖天 洞天 ， 南潜 飞潜 。 山灵 招隐L 年年 。 触 闲愁 万千 。
谒 尧帝庙L	唐	轩辕弥明	祖龙P 开国 尽 遐荒 ， 庙 建 唐尧P 镇 此邦 。 山卷 白云 朝 帝座 ， 林疏 红日 列 仙幢 。 巍巍 圣迹 陵 松峤 ， 荡荡 恩波 洽 桂江L 。 瞻仰 威灵 共 回首 ， 紫霞 深处 锁 轩窗 。
尧山L	元	吕思诚	尧山L 绝秀 岭南L 天 ， 雪压 林峦 飘 素烟 。 高倚 暮云 屏掩 翠 ， 半消 晴日 玉 开田 。 驿梅 逢腊 岩前 发 ， 羽檄 冲寒 徼外 传 。 何日 楼头 閒 拄笏 ， 两阶 舞罢 对 琼筵 。
尧山L 冬雪	明	严震直	朔风 从 东 来 ， 吹落 遥空 雪 ， 洒向 尧山L 顶 ， 相看 最 奇绝 。 银河 高插 玉 芙蓉 ， 上界 纡开 白银 阙 。 安南L 驿骑 如 星驰 ， 正是 天寒 岁暮 时 。 明朝 却过 桂阳岭L ， 一路 琼花 衬 马蹄 。
碧莲峰L	唐	沈彬	陶潜P 彭泽L 五株 柳 ， 潘岳P 河阳L 一县 花 。 两处 争如 阳朔L 好 ， 碧莲峰L 里 住 人家 。
阳朔L 山水 奇绝	宋	李纲	辍饭 支颐 看 翠微 ， 人间 应见 此山 稀 。 无从 学得 王维P 手 ， 画取 千峰 万壑 归 。
碧莲峰L	明	廖学古	碧光 万道 绕城 通 ， 拥出 碧莲L 接 太空 。 一色 翠屏 开 保障 ， 人家 都在 画图 中 。
舟 过 阳朔L	清	李秉礼	犬吠 知 村近 ， 谁家 水碓 舂 。 舟移 红蓼 岸 ， 县隐 碧莲峰L 。 瀑布 落 千丈 ， 林烟 深 几重 。 招提 在 何许 ？ 云外 一声 钟 。
望 桂林L 阳朔L 沿江 诸山 放歌	清	张联桂	桂林L 山势 天下 雄 ， 阳朔L 一境 多 奇峰 。 开窗 仰视 皆 突兀 ， 壁立 千仞 摩 苍穹 。 马驼 狮象 不 一状 ， 如瓶 如塔 如 金钟 。 云鬟 雾帔 降神 女 ， 虬髯 驼背 疑 仙翁 。 起伏 倚立 各 逞态 ， 或断 或续 江 西东 。 须臾 雨过 云 亦 散 ， 依旧 万朵 青 芙蓉 。
阳朔L 形胜	清	吴德徵	阳川L 百里 真 如 画 ， 历数 他州 得 似无 ？ 罗带L 潆洄 双水 曲 ， 剑芒 排插 万山 孤 。
清漓 石壁 图歌	清	阮元	天成 半壁 丹青 画 ， 幡然 高向 青天 挂 。 上古 何人 善 画山 ， 似 与 荆关P 斗 名派 。
画马	明	蒋冕	天间 腰袅 谁 能 画 ， 何处 丹青 有 曹霸P 。 此图 五马 尽 精神 ， 拟以 前人 亦 其 亚 。
无题	清	罗辰	山 以画 为名 ， 画 自天 公设 。 人间 老 画师 ， 到此 寸心 折 。 斯世 无 荆关P ， 画意 对谁 说 。
舟 经 秦渠L 即景 作	明	俞安期	秦渠L 曲曲 学 三巴L ， 离立 千峰 插地 斜 。 宛转 中间 穿水 去 ， 孤舟 长绕 碧莲花 。
兴安渠L	明	解缙	石渠L 南北 引 湘漓L ， 分水 塘深 下 作堤 。 若是 秦人 多 二纪 ， 锦帆 直是 到 天涯 。
分水岭L	明	鲁铎	一道 原泉 却 两支 ， 右为 湘水L 左为 漓L 。 谁知 万里 分流 去 ， 到海 还应 有 会时 。
柳州L 罗池庙L	唐	韩愈	荔子 丹 兮 蕉黄 ， 杂肴 蔬 兮 进 侯堂 。 侯 之 船 兮 两旗 ， 度 中 流 兮 风 泊之 ， 待侯 不来 兮 不知 我悲 。 侯 乘驹 兮 入庙 ， 慰 我 民 兮 不嚬 以笑 。 鹅之山L 兮 柳之水L ， 桂树 团团 兮 白石 齿齿 。 侯朝 出游 兮 暮来 归 ， 春 与 猨吟 兮 秋鹤 与 飞 。 北方 之 人 兮 为侯 是非 ， 千秋 万岁 兮 侯 无 我 违 。 福 我 兮 寿我 ， 驱 厉鬼 兮 山之左 。 下无 苦湿 兮 高 无干 ， 粳稌 充羡 兮 蛇蛟 结蟠 。 我 民 报事 兮 无怠 ， 其始 自今 兮 钦于 世世 。
谒 罗池庙L	元	陈孚	词华 一代 日星 尊 ， 茶臼 村童 俨 尚存 。 山左 竟 令 驱 厉鬼 ， 庭中 已悔 乞 天孙 。 善和里L 隔 生前 泪 ， 文惠祠P 封 死后 魂 。 欲奠 荔蕉 不知 处 ， 满池 榕叶 拥 朱门 。
罗池庙L	明	解缙	子厚P 文章 迈 汉唐 ， 可怜 祠宇 半 荒凉 。 罗池L 水涸 荷 应败 ， 惟有 穹碑 照 夕阳 。
经 梧州L	唐	宋之问	南国 无 霜霰 ， 连年 见 物华 。 青林 暗换 叶 ， 红橤 续 开花 。 春去 闻 山鸟 ， 秋来 见 海槎 。 流芳 虽 可悦 ， 会 自泣 长沙L 。
严关L	宋	范成大	回首 瘴岭L 已 无忧 ， 尚有 严关L 限 北洲L 。 裹饭 长歌 关外 去 ， 车 如 飞电 马 如 流 。
听 蜀僧 濬P 弹琴	唐	李白	蜀僧 抱 绿绮 ， 西下 峨眉峰L 。 为我 一 挥手 ， 如听 万壑 松 。 客心 洗 流水 ， 余响 入 霜钟 。 不觉 碧山 暮 ， 秋云 暗 几重 。
登 峨眉山L	唐	李白	蜀国 多 仙山 ， 峨眉L 邈 难匹 。 周流 试 登览 ， 绝怪 安 可悉 。 青冥 倚天 开 ， 彩错 疑 画 出 。 云间 吟 琼箫 ， 石上 弄 宝瑟 。 倘逢 骑 羊子 ， 携手 凌 白日 。
峨眉山L 月歌 送 蜀僧 晏人 中京L	唐	李白	我 在 巴东三峡L 时 ， 西看 明月 忆 峨眉L 。 月出 峨眉L 照 沧海 ， 与人 万里 长 相随 。 我 似 浮云 滞 吴越L ， 君 逢 圣主 游 丹阙 。 一振 高名 满 帝都L ， 归时 还弄 峨眉L 月 。
楚狂 接舆P 夫妻	唐	吴筠	接舆P 耽 冲玄 ， 伉俪 亦 真逸 。 一游 峨眉L 上 ， 千载 保 灵术 。
峨眉山L	宋	苏轼	峨眉山L 西 雪 千里 ， 北 望 成都L 如 井底 。 春风 日日 吹 不消 ， 五月T 行人 冻 如 蛭 。
初殿	宋	范镇	前去 峨眉L 最 上峰 ， 不知 岩嶂 几千 重 。 山僧 笑说 蒲公 事 ， 白鹿 曾 于此 发踪 。
眉山L 天下 秀	明	周洪漠	大峨L 两山 相对 开 ， 小峨L 迤逦 中峨L 来 。 二峨 之 秀 甲 天下 ， 何须 涉海 寻 蓬莱L 。 昔我 登临 彩云 表 ， 独骑 白鹤 招 青鸟 。 四时 青黛 如 绣绘 ， 岷嶓L 蔡蒙L 实 相对 。 昔生 三苏P 草木 枯 ， 但愿 再出 三苏L 辈 。
光相L	宋	范成大	胜峰L 高哉 摩 紫青 ， 白鹿 导 我 入 化城 。 住山大士P 喜客 至 ， 兜罗 布界 缤 相迎 。
雷洞坪L	宋	范成大	行人 魄动 风森森 ， 两崖 奔黑 愁 太 阴 。 不知 七十二洞L 处 ， 侧足 下窥 云海 深 。
游 峨	元	黄镇成	峨眉L 楼阁 现 虚空 ， 玉宇 高寒 下界 同 。 茶鼎 夜烹 千古 雪 ， 花幡 晨动 九天 风 。
宿 峰顶 次 济 定韵	明	方孝孺	层岩 削壁 跨 千里 ， 坐镇 西南L 势 独雄 。 元气 昆仑L 磅礴 外 ， 祥光 隐现 有无 中 。
峨眉山L	明	黄辉	剑外L 名山 聚 ， 峨眉L 不可 名 。 只疑 盘古P 雪 ， 化作 佛光 明 。 我 且 歌凤 去 ， 谁 当 骑象 行 。 兜罗 空 世界 ， 说法 了 无声 。
涵师 峨眉L 游归 因赠	清	方觐	峨眉L 西去 似 登天 ， 见说 亲行L 到 顶边 。 古木 千年 都 化石 ， 衲衣 六月T 总 装棉 。
大峨山L	清	刘儒	天下 峨眉L 秀 ， 乘云 结 胜 游 。 龙吟 千涧 雨 ， 树点 万峰 秋 。 今古 樽 前 过 ， 乾坤 眼底 收 。 兴阑 骑鹤 去 ， 摇曳 赴 沧洲L 。
伏虎寺L	清	张子仁	伏虎寺L 清幽 ， 峨眉L 在 上头 。 西天 留 境界 ， 疑是 梦魂 游 。
登 峨山L 绝顶	明	松朗	峨峰 巍巍 迥 绝群 ， 燕L 秦L 吴L 楚L 望 中分 。 寰区 五岳 河图 内 ， 塞外 蛮江 静 不闻 。
登 锦城L 散花楼	唐	李白	日照 锦城L 头 ， 朝光 散花楼 。 金窗 夹 绣户 ， 珠箔 悬 琼钩 。 飞梯 绿云 中 ， 极目 散 我 忧 。 暮雨 向 三峡L ， 春江 绕 双流L 。 今来 一 登望 ， 如上 九天 游 。
上皇 西巡 南京L 歌 （ 十首 之二 ）	唐	李白	九天 开出 一 成都L ， 万户 千门 入 画图 。 草树 云山 如 锦绣 ， 秦川L 得及 此间 无 。
上皇 西巡 南京L 歌 （ 十首 之六 ）	唐	李白	濯锦 清江L 万里 流 ， 云帆 龙舸 下 扬州L 。 北地 虽夸 上林苑 ， 南京L 还有 散花楼 。
登楼	唐	杜甫	花近 高楼 伤 客心 ， 万方 多难 此 登临 。 锦江L 春色 来 天地 ， 玉垒L 浮云 变 古今 。 北极 朝廷 终 不改 ， 西山L 寇盗 莫 相侵 。 可怜 后主P 还 祠庙 ， 日暮 聊为 梁父吟 。
赠 花卿	唐	杜甫	锦城L 丝管 日 纷纷 ， 半入 江风 半入 云 。 此曲 只应 天上 有 ， 人间 能得 几回 闻 。
成都L 曲	唐	张籍	锦江L 近西L 烟水 绿 ， 新雨 山头L 荔枝 熟 。 万里桥 边 多 酒家 ， 游人 爱 向 谁家 宿 ？
杜工部P 蜀中 离席	唐	李商隐	人生 何处 不 离群 ， 世路 干戈 惜 暂分 。 雪岭L 未归 天外使 ， 松州L 犹驻 殿前军 。 座中 醉客 延 醒客 ， 江上 晴云 杂 雨云 。 美酒 成都L 堪 送老 ， 当垆 仍是 卓文君P 。
成都L	宋	宋祁	风物 繁雄 古 奥区L ， 十年 伧父 巧 论都 。 云藏 海客 星间 石 ， 花识 文君P 酒处 垆 。 两剑 作关 屏 对绕 ， 二江 联派 练 平铺 。 此时 全盛 超 西汉T ， 还有 渊云P 抒 颂 无 。
成都L 书事	宋	陆游	剑南L 山水 尽 清辉 ， 濯锦江L 边 天下 稀 。 烟柳 不遮 楼角 断 ， 风花 时傍 马头 飞 。 芼 羹笋 似 稽山L 美 ， 斫 脍鱼 如 笠泽L 肥 。 客报 城西 有 园 卖 ， 老夫 白首 欲 忘归 。
成都L 行	宋	陆游	依 锦瑟 ， 击 玉壶 ， 吴中 狂士 游 成都L 。 成都L 海棠 十万 株 ， 繁华 盛丽 天下 无 。 青丝 金络 白雪 驹 ， 日斜 驰遣 迎 名姝 。 东来 此欢 堕 空欢 ， 坐悲 新霜 点 鬓须 。 易求 合浦L 千斛 珠 ， 难觅 锦江L 双 鲤鱼 。
怀 成都L 十韵	宋	陆游	放翁 五十 犹 豪纵 。 锦城L 一觉 繁华 梦 。 竹叶 春醪 碧玉壶 ， 桃花 骏马 青丝鞚 。 酒徒 诗社 朝暮 忙 ， 日月 匆匆 迭宾 送 。 浮世 堪惊 老 已 成 ， 虚名 自笑 今 何用 。 北窗 风雨 耿 青灯 ， 旧游 欲说 无人 共 。
梅花 绝句	宋	陆游	当年 走马 锦城L 西 ， 曾为 梅花 醉 似 泥 。 二十里 中 香 不断 ， 青羊宫L 到 浣花溪L 。
成都L	宋	汪元量	锦城L 满目 是 烟花 ， 处处 红楼 卖 酒家 。 坐看 浮云 横 玉垒L ， 行观 流水 荡 金沙 。 巴童 栈道 骑 高马 ， 蜀卒 城门 射 老鸦 。 见说 近来 多 盗蹠 ， 夜深 战鼓 不停 挝 。
武侯庙L 古柏	唐	李商隐	蜀相 阶前 柏 ， 龙蛇 捧 閟宫 。 阴成 外江L 畔 ， 老向 惠陵 东 。 大树 思 冯异P ， 甘棠 忆 召公P 。 叶凋 湘燕 雨 ， 枝折 海鹏 风 。 玉垒L 经纶 远 ， 金刀 历数 尽 。 谁 将 出师表 ， 一为 问 昭融 。
古柏行	唐	杜甫	孔明庙L 前 有 老柏 ， 柯 如 青铜 根 如 石 。 霜皮 溜雨 四十 围 ， 黛色 参天 二千尺 。 大厦 如 倾 要 梁栋 ， 万牛 回首 邱山 重 。 志士 幽人 莫 怨嗟 ， 古来 材大 难为 用 。
先主 武侯庙L	唐	岑参	先主P 与 武侯P ， 相逢 云雷 际 。 感通 君臣 分 ， 义激 鱼水 契 。 遗庙 空 肃然 ， 英灵 贯 千岁 。
堂成	唐	杜甫	背郭 堂成 荫 白茅 ， 缘江 路熟 俯 青郊 。 桤林 碍日 吟 风叶 ， 笼竹 和烟 滴 露梢 。 暂止 飞乌 将 数子 ， 频来 语燕 定 新巢 。 旁人 错比 扬雄P 宅 ， 懒惰 无心 作 解嘲 。
狂夫	唐	杜甫	万里 桥西 一 草堂L ， 百花潭L 水 即 沧浪 。 风含 翠筱 娟娟 净 ， 雨浥 红蕖 冉冉 香 。 厚禄 故人 书 断绝 ， 恒饥 稚子 色 凄凉 。 欲 填 沟壑 惟 疏放 ， 自笑 狂夫 老 更 狂 。
绝句 四首之一	唐	杜甫	两个 黄鹂 鸣 翠柳 ， 一行 白鹭 上 青天 。 窗含 西岭L 千秋 雪 ， 门泊 东吴L 万里 船 。
经 杜甫P 旧宅	唐	雍陶	浣花溪L 里 花 多处 ， 为 忆 先生 在 蜀时L 。 万古 只应 留 旧宅 ， 千金 无复 换 新诗 。 沙崩 水栏 鸥 飞尽 ， 树压 村桥 马 过 迟 。 山月 不知 人事 变 ， 夜来 江上 与 谁 期 。
草堂L 拜 少陵 遗像	宋	陆游	清江L 抱 孤村 ， 杜子 昔 所馆 。 虚堂 尘 不扫 ， 小径 门 可款 。 公诗 岂 纸上 ， 遗句 处处 满 。 人皆 欲 拾取 ， 志大 才 苦短 。 计公 客 此时 ， 一饱 得 亦 罕 。 阨穷 端 有自 ， 宁 独坐 房琯 。 至今 壁间 像 ， 朱绶 意 萧散 。 长安L 貂蝉 多 ， 死去 谁 复 算 。
泛舟 浣花溪L 东阜L 狷斋 同赋	明	杨慎	风檐 水槛 含 清辉 ， 月闰T 夏五 暑气 微 。 山中 薜荔 幽人 带 ， 池上 芰荷 游子 衣 。 双鱼 六马 惯 识曲 ， 青蛉 白鸥 皆 忘机 。 扬雄P 玄阁 不 寂寞 ， 杜甫草堂L 天下 稀 。
重游 草堂L	清	董大椿	万里 桥西 溪水 头 ， 少陵 故宅 自 深幽 。 美花 疏竹 旧游 地 ， 老树 遗台 今日 秋 。 古瓦 时多 苍鼠 窜 ， 荒林 惟有 白云 留 。 江关L 词赋 空 萧瑟 ， 庾信P 平生 一样 愁 。
少陵草堂L	清	钱源来	飘泊 干戈 后 ， 为堂 傍 水涯 。 三巴L 五亩 宅 ， 千古 一诗 家 。 无复 临江 树 ， 犹存 覆地 花 。 危楼 当 北斗 ， 想象 望 京华L 。
乡思	唐	薛涛	峨眉山L 下 水 如 油 ， 怜 我 心同 不系 舟 。 何日 片帆 离 锦浦L ， 棹声 齐唱 发 中流 。
题 竹郎庙L	唐	薛涛	竹郎庙L 前 多 古木 ， 夕阳 沉沉 山 更 绿 。 何处 江村 有 笛声 ？ 声声 尽是 迎郎曲 。
寄赠 薛涛P	唐	元稹	锦江L 滑腻 峨眉L 秀 ， 幻出 文君P 与 薛涛P 。 言语 巧偷 鹦鹉 舌 ， 文章 分得 凤凰 毛 。 纷纷 词客 多 停笔 ， 个个 公卿 欲 梦刀 。 别后 相思 隔 烟水 ， 菖蒲 花发 五云 高 。
寄 薛涛P	唐	白居易	峨眉L 山势 接 云霓 ， 欲逐 刘郎P 意 转迷 。 若似 剡中 无路 到 ， 春风 犹隔 武陵溪L 。
黄梅L 樵 以 薛洪度P 小像 索题 为作 二绝句 （ 选一 ）	宋	陈一津	名士 最怜 苏小小P ， 内廷 曾识 李师师P 。 而今 粉黛 风流 尽 ， 毕竟 留存 一卷 诗 。
薛涛井L	清	张珽	锦江L 西畔 草堂 前 ， 香井 碑题 尚 宛然 。 小擘 锦笺 吟 短句 ， 可怜 花样 似 当年 。
送 杨昀谷P 使君 之 蜀	清	赵熙	春水 香流 万里桥 ， 枇杷 门巷 倚 楼 高 。 井泉 艳过 花笺 色 ， 便恐 桃花 是 薛涛P 。
薛涛井L 怀古	清	陈矩	无波 古井 因 涛 重 ， 有色 遗笺 举世 珍 。 忆 我 清江L 曾 拜井 ， 今游 井上 吊 诗人 。
成都L 竹枝 诗	清	王再咸	昭烈祠L 前 栋宇 新 ， 校书 坟畔 碧桃 春 。 江山 莫谓 全 无主 ， 半属 英雄 半 美人 。
成都L 崇丽阁L	清	严光祖	崇丽阁L 雄 蜀江渚L ， 望 美人 兮 想 歌舞 。 开轩 俯看 峨眉L 云 ， 归帆 远带 巫山L 雨 。 波光 云影 两 悠悠 ， 春去 春来 夏 复 秋 。 昔日 枇杷 人 不见 ， 浣花江L 上 水 空流 。
江楼 即事	清	李承邺	吟诗 濯锦L 两江 楼 ， 杰阁L 巍巍 势 更遒 。 全蜀 河山 归 领袖 ， 一川 景物 豁 心眸 。 春风 载酒 怀 犹 畅 ， 夜月 凌波 兴 倍 幽 。 独有 香魂 招 不得 ， 花笺 空见 艳名 留 。
吟诗楼L	清	张怀溥	碧鸡 坊里 樱桃 花 ， 欲开 不开 临 狭斜 。 花间 婉转 双黄 鸟 ， 交交 似诉 美人 家 。 美人 家本 长安L 住 ， 咳唾 九天 随 烟雾 。 偶吟 桐叶 落 人间 ， 始悔 才名 半生 误 。 风雨 瑟居 楼头 上 ， 楼前 车马 半 诸侯 。 摧拈 银管 花 初放 ， 写罢 松笺 腕 更柔 。 锦城L 将军 夜 挝 鼓 ， 酣歌 那识 沙场 苦 。 法曲 当筵 试 一吹 ， 十万 征夫 泪 如 雨 。 文章 声价 五云 高 ， 名流 惊宠 凤凰 毛 。 一时 画手 知 多少 ， 不画 崔徽P 画 薛涛P 。 倾国 倾城 今 已矣 ， 地下 香魂 呼 不起 。 此地 空传 百尺 楼 ， 当年 难念 高 千里 。 我 昨 枇杷 门外 过 ， 门前 春水 绿 于 螺 。 拂波 千丝 万丝 柳 ， 犹 学 风流 当 奈何 。
成都L 杂咏	清	曾宝和	锦江L 春色 自 年年 ， 江上 楼高 水 接天 。 枨触 千秋 空 艳迹 ， 桃花 红 让 女儿 笺 。
陈 幼学 杨 南皋 艾缉 光诸T 同人 游 江楼	清	吴虞	桐叶 萧萧 古井 秋 ， 名笺 犹自 见 风流 。 陆沉 多少 神州 感 ， 莫认 兰亭L 是 盛游 。
琴台	唐	杜甫	茂陵L 多病 后 ， 尚爱 卓文君P 。 酒肆 人间 世 ， 琴台L 日暮 云 。 野花 留 宝靥 ， 蔓草 见 罗裙 。 归凤 求 凰意 ， 寥寥 不复 闻 。
司马相如P 琴台	唐	岑参	相如琴台L 古 ， 人去 台 亦 空 。 台上 寒 萧瑟 ， 至今 多 悲风 。 荒台 汉时 月 ， 色 与 旧时 同 。
再游 文君井L	宋	陆游	落魄 西川L 泥 酒杯 ， 酒酣 几度 上 琴台 。 青鞋 自笑 无 羁束 ， 又向 文君井L 畔 来 。
琴台 有感	清	田况	西汉T 文章 世 所 稀 ， 相如P 宏丽 冠 当时 。 游人 不赏 凌云赋 ， 只说 琴台 是 故墓 。
峨眉L 山月歌	唐	李白	峨眉L 山月 半轮 秋 ， 影入 平羌L 江水 流 。 夜发 清溪L 向 三峡L ， 思君 不见 下 渝州L 。
宿 青溪驿L 奉怀 张员外 十兄 之 绪	唐	杜甫	漾舟 千山 内 ， 日入 泊 枉渚L 。 我 生 本 飘飘 ， 今 复 在 何许 。 中夜 怀 友朋 ， 乾坤 此 深阻 。 浩荡 前后 间 ， 佳期 赴 荆楚L 。
登 嘉州L 凌云寺L 作	唐	岑参	寺出 飞鸟 外 ， 青峰 戴 朱楼 。 博壁 跻 半空 ， 喜得 登上 头 。 始知 宇宙 阔 ， 下看 三江 流 。 天晴 见 峨眉L ， 如 向 波上 浮 。
送 张嘉州P	宋	苏轼	生不 愿封 万户侯 ， 亦 不愿 识 韩荆州P 。 但愿 身为 汉嘉L 守 ， 载酒 时 作 凌云L 游 。 峨眉L 山月 半轮 秋 ， 影入 平羌L 江水 流 。 谪仙 此语 谁 解道 ， 请君 看月 时 登楼 。
初发 嘉州L	宋	苏辙	巉巉 九顶峰L ， 可爱 不可 住 。 飞舟 过 山足 ， 佛脚 见 江浒 。 舟人 尽 敛容 ， 竟 欲 揖 其 拇 。 俄顷 已 不见 ， 乌牛L 在 中诸 。
凌云寺L	唐	薛能	像阁 与 山齐 ， 何人 致 石梯 。 万烟 生 聚落 ， 一崦 露 招提 。 斋月 人 来 上 ， 残阳 鸽 去栖 。 从边 亦 已极 ， 烽火 是 沈黎L 。
登 荔支楼L	宋	陆游	平羌L 江水 接 天流 ， 凉入 帘栊 已是 秋 。 唤作 主人 元 是 客 ， 知非 吾土 强 登楼 。 闲凭 曲栏 尝 忘去 ， 欲下 危楼 更 小留 。 公事 无多 厨酿 美 ， 此身 不负 负 嘉州L 。
凌云L 归作	宋	陆游	峨眉L 月入 平羌L 水 ， 叹息 吾行 俄 至此 。 谪仙 一去 五百年 ， 至今 醉魂 呼不起 。 玻璃 春满 琉璃 钟 ， 宦情 苦薄 酒兴 浓 。 饮如 长鲸 渴 赴海 ， 诗成 放笔 千觞 空 。 十年 看尽 人间 事 ， 更觉 曲生 偏 有味 。
舟中 对月	宋	陆游	百壶 载酒 游 凌云L ， 醉后 挥袖 别 故人 。 依依 向我 不忍 别 ， 谁似 峨眉L 半轮 月 。 月窥 船窗 挂 凄冷 ， 欲到 渝州L 酒 初醒 。 江空 袅袅 钩丝 风 ， 人静 翩翩 葛巾 影 。 哦诗 不睡 月满 船 ， 清寒 入骨 我 欲仙 。
嘉阳L 登舟	清	王士祯	青衣江水L 碧鳞鳞 ， 夹岸 山容 索笑 新 。 怅望 三峨L 九秋 色 ， 飘零 万里 一 归人 。 亭台 处处 余 金粉 ， 城郭 家家 绕 绿萍 。 信宿 嘉州L 如 旧识 ， 荔支楼L 好 对 江津L 。
登高 望楼	清	王士祯	风流 曾说 荔支楼L ， 栏槛 高明 压 四州L 。 峨顶 晚霞 寒 白雪 ， 江心 残照 出 乌尤L 。 云烟 早暮 还 殊态 ， 枫桕 丹黄 只 似 秋 。 自笑 心情 无赖 甚 ， 清晨 临眺 不 梳头 。
晚渡 平羌江L 步上 凌云L 绝顶	清	王士祯	真 作 凌云L 载酒 游 ， 汉嘉L 奇绝 冠 西州L 。 九峰 向日 吟 江叶 ， 三水 通潮 抱 郡楼 。 山 自 涪翁亭L 畔 好 ， 泉 从 古佛 髻中 流 。 东坡P 老去 方 思蜀 ， 不愿 人间 万户 侯 。
嘉定L 舟中 作	清	张问陶	平羌江水L 绿 迢迢 ， 梦 冷 峨眉L 雪 未消 。 爱看 汉嘉L 山 万叠 ， 一山 奇处 一 停桡 。
乌尤寺L	清	陶闿士	秋到 乌尤L 万竹 凉 ， 一堆 浓绿 水 中央 。 秦时 明月 依然 在 ， 老对 山僧 话 夕阳 。
江行 望 乌尤寺L	清	王士祯	墨鱼 吹浪 一 江浮 ， 尔雅 台荒 古木 秋 。 碧水 丹山 留不得 ， 风帆 回首 别 乌尤L 。
嘉定L 舟中 作 （ 二首之一）	清	张问陶	凌云L 西岸 古 嘉州L ， 江水 潺湲 抱 郭 流 。 绿影 一堆 飘 不去 ， 推船 三面 看 乌尤L 。
自 峨眉L 归望 乌尤L	清	赵熙	一塔 见 嘉州L ， 铜江L 水 合流 。 好山 似 神女 ， 明镜 照 乌尤L 。 渡远 人 争市 ， 天空 雁 入秋 。 西风 渔 唱晚 ， 黄叶 夕阳 秋 。
苏祠L 怀古	明	杨慎	眉山学士P 百代 豪 ， 夜郎 谪仙P 两 争高 。 岷峨L 凌云L 掞 天藻 ， 江汉 流汤 驱 砚涛 。 虎豹 虬龙 自 登踞 ， 鳅鳝 狐狸 休 舞号 。 井络 钟灵 竟 谁 继 ， 海若 望洋 增 我 劳 。
丈人山L	唐	杜甫	自为 青城L 客 ， 不唾 青城L 地 。 为爱 丈人山L ， 丹梯 近 幽意 。 丈人 祠西 佳气 浓 ， 缘云 拟住 最高峰 。 埽除 白发 黄精 在 ， 君 看 他时 冰雪 容 。
送 福上人 还 青城L	明	杨慎	青城L 三十六 高峰 ， 寺 在 青峰 第几重 。 飞锡 曾 闻 经 雪岭 ， 结茅 常 爱 住 云松 。 花飘 香界 诸天 雨 ， 金吼 霜林 半夜 钟 。 传语 禅关 休 上锁 ， 虎溪L 他日 会 相从 。
望 青城山L	清	王士祯	云气 连 西域L ， 名山 作 汉标 。 千秋 轩帝P 迹 ， 每夜 岳灵 朝 。 玉宇 凌 丹壑 ， 神灯 下 碧霄 。 丈人 一 招手 ， 天路 应 未遥 。
上清宫	宋	范成大	历井 扪参 兴 未阑 ， 丹梯 通处 更 跻攀 。 冥濛 蜀道 一 云气 ， 破碎 岷山L 千 髻鬟 。 但觉 星辰 垂 地上 ， 不知 风雨 满 人间 。 蜗牛 两角 犹如 梦 ， 更说 纷纷 触 与 蛮 。
宣城L 见 杜鹃花	唐	李白	蜀国L 曾闻 子规鸟 ， 宣城L 还见 杜鹃花 。 一叫 一回 肠 一断 ， 三春 三月T 忆 三巴L 。
瞿唐L 两崖	唐	杜甫	三峡L 传 何处 ？ 双崖 壮 此门 。 入天 犹 石色 ， 穿水 忽 云根 。 猱玃 须 髯古 ， 蛟龙 窟 宅尊 。 羲和 冬 驭近 ， 愁畏 日车 翻 。
夜入 瞿唐峡L	唐	白居易	瞿唐L 天下 险 ， 夜上 信 难 哉 。 岸 似 双屏 合 ， 天 如 匹练 开 。 逆风 惊浪 起 ， 拔艌 暗船 来 。 欲识 愁 多少 ， 高于 滟滪 堆 。
瞿唐L 行	唐	白居易	上有 万仞山 ， 下有 千丈水 。 苍苍 两岩 间 ， 阔狭 容 一苇 。 瞿唐L 呀 直泻 ， 滟滪 屹中 峙 。 未夜 里 岩昏 ， 无风 白浪 起 。 大石 如 利剑 ， 小石 如 牙齿 。 一步 不可 行 ， 况 千三百 里 。
醉中 下 瞿唐峡L 中流 观 石壁 飞泉	宋	陆游	吾舟 十丈 如 青蛟 ， 乘风 翔舞 从 天下 。 江流 触地 白盐 动 ， 滟滪 浮波 真 一马 。 主人 满酌 白玉 杯 ， 旗下 画鼓 如 春雷 。 回头 已失 瀼西市L ， 奇 哉 ， 一削 千仞 之 苍崖 ！ 苍崖 中裂 银河 飞 ， 空里 万斛 倾 珠玑 。 醉面 正须 迎 乱点 ， 京尘 未许 化 征衣 。
瞿唐L 上峡	明	沈庆	三峡L 瞿唐L 据 上游 ， 险由 天设 古今 留 。 云烟 翳树 猿猱 下 ， 风浪 翻江 贾客 愁 。 山势 西来 开 蜀道 ， 水声 东去 会 湘流L 。 天桥 铁柱 连环 锁 ， 驻节 看碑 忘 远游 。
瞿唐L 、 巫峡L	清	张问陶	瞿唐L 蟠大壁L ， 巫峡L 削 千峰 。 处处 奇 相敌 ， 山山 妙 不重 。 诗 随 林壑 变 ， 天辟 画图 浓 。 何日 真 游遍 ， 穿云 策 短筇 。
瞿唐L	清	孙元恒	白帝 荒城 带 雨昏 ， 瞿唐L 高浪 挟 雷奔 。 双崖 积铁 封 三峡L ， 众水 排山 争 一门 。 鱼腹 浦悬 鱼鸟阵 ， 虎须滩 变 虎狼村 。 卧龙P 跃马 空 回首 ， 壮士 当关 几并 吞 。
白帝L	唐	杜甫	白帝城L 中 云 出门 ， 白帝城L 下 雨 翻盆 。 高江 急峡 雷霆 斗 ， 翠木 苍藤 日月 昏 。 戎马 不如 归马 逸 ， 千家 今有 几家 存 。 哀哀 寡妇 诛求 尽 ， 恸哭 秋原 何处 村 。
咏怀 古迹 （ 五首之一）	唐	杜甫	蜀主P 窥吴 幸 三峡L ， 崩年 亦 在 永安宫L 。 翠华 想象 空山 外 ， 玉殿 虚无 野寺 中 。 古庙 杉松 巢 水鸭 ， 岁时 伏腊 走 村翁 。 武侯祠L 屋 常 临近 ， 一体 君臣 祭祀 同 。
永安宫L	宋	苏轼	千古 陵谷 变 ， 故宫 安得 存 。 徘徊 问 耆老 ， 惟有 永安门 。 游人 杂 楚蜀L ， 车马 晚 喧喧 。 不见 重楼 好 ， 谁知 昔日 尊 。 吁嗟 蜀先主 ， 兵败 此 亡魂 。 只应 法正P 死 ， 使 公 去 遭燔 。
峡中 铁柱	元	何同男	白帝城L 边 春草 生 ， 黄牛峡L 里 水波 清 。 追思 昭烈 千年 事 ， 长使 英雄 气 不平 。
白帝城L	宋	宋肇	江雨 霏霏 白帝城L ， 秋草 未枯 春草 生 。 古来 战垒 如云 横 ， 万里 瞿塘L 断 人行 。 至今 三峡L 路 峥嵘 ， 时清 不见 更 屯兵 。 荒凉 废堞 没 春耕 ， 但见 牛羊 日西 平 。
同 耿明 府登 白帝城L	明	袁茂英	突兀 危城 瞰 大江 ， 万波 浮动 势 茫茫 。 夔门L 日落 风云 暗 ， 鱼复L 沙深 图阵 黄 。 天立 孤根 堆滟滪 ， 地开 三峡L 锁 瞿唐L 。 登临 欲 赋 惭 工部 ， 瀼水L 东西 自 草堂 。
登 白帝城L	清	王士祯	白盐 赤甲 相向 生 ， 丹青 绝壁 斗 峥嵘 。 千江 一线 虎须口L ， 万里 孤帆 鱼复城L 。 跃马 雄图 余垒 迹 ， 卧龙遗庙 枕潮 声 。 飞楼 直上 闻 哀角 ， 落日 涛头 气 不平 。
秋兴 八首 （ 选一 ）	唐	杜甫	玉露 凋伤 枫树林 ， 巫山L 巫峡L 气 萧森 。 江间 波浪 兼天 涌 ， 塞上 风云 接地 阴 。 丛菊 两开 他日 泪 ， 孤舟 一系 故园 心 。 寒衣 处处 催 刀尺 ， 白帝城L 高 急 暮砧 。
咏怀 古迹 （ 五首之一 ）	唐	杜甫	支离 东北L 风尘 际 ， 漂泊 西南L 天地 间 。 三峡L 楼台 淹 日月 ， 五溪L 衣服 共 云山 。 羯胡L 事主 终 无赖 ， 词客 哀时 且 未还 。 庾信P 平生 最 萧瑟 ， 暮年 诗赋 动 江关L 。
阁夜	唐	杜甫	岁暮 阴阳 催 短景 ， 天涯 霜雪 霁 寒宵 。 五更T 鼓角 声 悲壮 ， 三峡L 星河 影 动摇 。 野哭 千家 闻 战伐 ， 夷歌 几处 起 渔樵 。 卧龙跃马P 终 黄土 ， 人事 音书 漫 寂寥 。
草堂 遗韵	清	王知人	鼙鼓 渔阳L 势 欲奔 ， 吞声 野老 下 夔门L 。 青山 一带 围 寒骨 ， 茅屋 三椽 慰 旅魂 。 邈 矣 逸怀 飘 断垒 ， 至今 诗色 满江 村 。 菜花 蛱蝶 啼鹃 泪 ， 为报 春风 护 绿城 。
八阵图L	唐	杜甫	功盖 三分 国 ， 名成 八阵图L 。 江流 石 不转 ， 遗恨 失 吞吴 。
八阵图L	宋	苏轼	平沙 何 茫茫 ， 仿佛 见 石蕝 。 纵横 满江 上 ， 岁岁 沙水 啮 。 孔明P 死 已久 ， 谁 复 辨 行列 。 唯余 八阵图L ， 千古 壮 夔峡L 。
八阵碛L	宋	苏辙	涨江 吹 八阵L ， 江落 阵 如故 。 登高 望 遗迹 ， 垒垒 六四 数 。 遥指 如 布棋 ， 就视 不知 处 。 世称 诸葛公P ， 用众 有 法度 。
八阵图L	清	傅作揖	千里 连营 制胜 难 ， 十年 生聚 漫 摧残 。 北山 猛兽 何时 缚 ， 东浦L 孤雏 不可 弹 。 劫火 只今 余 石垒 ， 风云 空自 涌 江湍 。 伤心 八阵图L 边 水 ， 呜咽 隆中 泪 未干 。
晚登 夔府L 东城楼 望 八阵图L	清	王士祯	永安宫殿L 莽 榛芜 ， 炎汉 存亡 六尺 孤 。 城上 风云 犹 护蜀 ， 江间 波浪 失 吞吴 。 鱼龙 夜偃 三巴L 路 ， 蛇鸟 秋悬 八阵图L 。 搔首 桓公P 凭吊处 ， 猿声 落日 满 夔巫L 。
滟滪L	宋	王十朋	水涨 瞿唐L 势 更危 ， 舟人 贪进 只嫌 迟 。 天 将 此石 垂深 戒 ， 看取 形如 象马 时 。
滟滪堆L	清	傅作揖	莽莽 长江L 来 ， 谁敢 冲 其 波 。 奇哉 滟滪堆L ， 乃欲 吞 江河 。 白盐L 为 犄角 ， 赤甲L 为 长戈 。 瀼溪L 双 铁柱 ， 风雨 今 如何 。
滟滪石L	清	王怀曾	不到 瞿唐峡L ， 焉知 滟滪尊L 。 群龙 翻 地轴 ， 一象 塞 天门 。 下有 支祈 锁 ， 旁留 陈迹 存 。 忽闻 江水 啸 ， 风雨 下 黄昏 。
滟滪堆L	清	胡期恒	大江 西来 四千里 ， 争入 夔门L 一线 天 。 夔门L 逼仄 不肯 受 ， 回波 卷浪 青云 巅 。 奇哉 峡口 滟滪石L ， 巍然 独立 江 中间 。 千溪 万壑 雷电 激 ， 中流 一柱 来 当前 。
滟滪L 回澜	清	王知人	神禹P 推承 造化 功 ， 故 留 突兀 大江 中 。 三更 出没 鱼龙 哭 ， 万里 腾奔 鼓角 雄 。 湘楚L 有峰 皆 向北 ， 巴渝L 无派 不 朝东 。 风风雨雨 波涛 老 ， 峡口 依然 倚 碧空 。
折 杨柳	南朝	萧绎	巫山L 巫峡L 长 ， 垂柳 复 垂杨 。 同心 且 同折 ， 故人 怀 故乡 。 山 似 莲花 艳 ， 流 如 明月 光 。 寒夜 猿声 彻 ， 游子 泪 沾裳 。
巫山L 高	南朝	王融	想象 巫山L 高 ， 薄暮 阳台 曲 。 烟云 乍 舒卷 ， 猿鸟 时 断续 。 彼 美 如 可期 ， 寤言 纷 在瞩 。 怃然 坐 相望 ， 秋风 下 庭绿 。
巫山L 高	南朝	虞羲	南国L 多 奇山 ， 荆巫L 独 灵异 。 云雨 丽 以 佳 ， 阳台 千里 思 。 勿言 可 再得 ， 特美 君王 意 。 高唐L 一 断绝 ， 光阴 不可 迟 。
巫山L 高	南朝	范云	巫山L 高 不极 ， 白日 隐 光辉 。 霭霭 朝云 去 ， 溟溟 暮雨 归 。 岩悬 兽 无迹 ， 林暗 鸟 疑 飞 。 枕席 竟 谁荐 ， 相望 空 依依 。
巫峡L	唐	杨烱	三峡L 七百里 ， 唯言 巫峡L 长 。 重岩 窅 不极 ， 迭嶂 凌 苍苍 。 入夜 分明 见 ， 无风 波浪 狂 。 美人 今 何在 ， 灵芝 自 有芳 。 山空 夜 猿啸 ， 征客 泪 沾裳 。
巫山峡L	唐	皇甫冉	巫峡L 见 巴东L ， 迢迢 出 半空 。 云藏 神女馆 ， 雨到 楚王宫 。 朝暮 泉声 落 ， 寒暄 树色 同 。 清猿 不可 听 ， 偏 在 九秋T 中 。
自 巴东L 舟行 经 瞿唐峡L 登 巫山L 最高峰 晚还 题壁	唐	李白	江行 几千里 ， 海月 十五 圆 。 始经 瞿唐峡L ， 遂步 巫山L 巅 。 巫山L 高 不穷 ， 巴国L 尽 所历 。 日边 攀 垂萝 ， 霞外 倚 穹石 。 飞步 凌 绝顶 ， 极目 无 纤烟 。 却顾 失 舟壑 ， 仰观 临 青天 。 青天 若 可扪 ， 银汉 去 安在 。 望云 知 苍梧 ， 记水 辨 瀛海L 。 周游 孤光 晚 ， 历览 幽意 多 。 积雪 照 空谷 ， 悲风 鸣 森柯 。 归途 行 欲曛 ， 佳趣 尚 未歇 。 江寒 早 啼猿 ， 松暝 已 吐月 。 月色 何 悠悠 ， 清猿 响啾啾 。 辞山 不忍 听 ， 挥策 还 孤舟 。
宿 巫山L 下	唐	李白	昨夜 巫山L 下 ， 猿声 梦里 长 。 桃花 飞 渌水 ， 三月 下 瞿唐L 。 雨色 风 吹去 ， 南行 拂 楚王P 。 高丘L 怀 宋玉 ， 访古 一 沾裳 。
巫山L 曲	唐	孟郊	巴江L 上峡 重 复 重 ， 阳台 碧峭 十二峰 。 荆王P 猎时 逢 暮雨 ， 夜卧 高丘L 梦 神女 。 轻红 流烟 湿 艳姿 ， 行云 飞去 明星 稀 。 目极 魂断 望 不见 ， 猿啼 三声 泪滴 衣 。
竹枝 词	唐	刘禹锡	巫峡L 苍苍 烟雨 时 ， 清猿 啼 在 最高 枝 。 个里 愁人 肠 自断 ， 由来 不是 此声 悲 。
巫山L 神女	唐	刘方平	神女 藏 难识 ， 巫山L 秀 莫群 。 今宵 为 大雨 ， 昨日 作 孤云 。 散漫 愁 巴峡L ， 徘徊 恋 楚君P 。 先王 立为 庙 ， 春树 几 氛氲 。
巫山L 高	唐	李贺	碧丛丛 ， 高 插天 ， 大江 翻澜 神曳 烟 。 梦魂 寻梦 风 飔然 ， 晓风 飞雨 生 苔钱 。 瑶姬P 一去 一千年 ， 丁香 筇竹 啼 老猿 。 古祠 近月 蟾桂 寒 ， 椒花 坠红 湿 云间 。
荆渚L 中流 ， 回望 巫山L ， 无复 一点 ， 戏成 短歌	宋	范成大	千峰 万峰 巴峡L 里 ， 不信 人间 有 平地 。 渚宫 回望 水 连天 ， 却疑 平地 原 无山 。 山川 相迎 复 相送 ， 转头 变灭 都 如梦 。 归程 万里 今 三千 ， 几梦 都到 石湖 边 。
巫峡L 啼 猿歌 送 邱少府P 归 四明L	明	林鸿	巫山L 巫峡L 连 三巴L ， 猿啼 三声 客 思家 。 停舟 听之 声 未了 ， 却过 青枝 犹 袅袅 。
舟过 巫峡L	明	卢谦	日落 瞿唐L 上 ， 猿啼 两岸 空 。 山藏 神女庙 ， 浪接 楚王宫L 。 飞峡 云容 白 ， 悬江 树影 红 。 推蓬 才 一瞬 ， 已过 万山 中 。
观 元丹丘P 坐 巫山L 屏风	唐	李白	昔游 三峡L 见 巫山L ， 见画 巫山L 宛 相似 。 疑是 天边 十二峰L ， 飞入 君家 彩屏 里 。 寒松 萧瑟 如 有声 ， 阳台 微茫 如 有情 。 锦衾 瑶席 何 寂寂 ， 楚王P 神女 徒 盈盈 。 高 咫尺 ， 如 千里 ， 翠屏 丹崖 灿 如 绮 。 苍苍 远树 围 荆门L ， 历历 行舟 泛 巴水 。 水石 潺湲 万壑 分 ， 烟光 草色 俱 氛氲 。 溪花 笑日 何年 发 ， 江客 听猿 几岁 闻 。 使人 对此 心 缅邈 ， 疑入 嵩丘L 梦 綵云 。
巫山 神女庙L	唐	刘禹锡	巫山十二L 郁苍苍 ， 片石 亭亭 号 女郎 。 晓雾 乍开 疑 卷幔 ， 山花 欲 谢 似 残妆 。
巫山L 高	唐	李端	巫山十二峰L ， 皆在 碧虚 中 。 回合 云 藏月 ， 霏微 雨 带 风 。 猿声 寒 过涧 ， 树色 暮 连空 。 愁向 高唐L 望 ， 清秋 见 楚宫L 。
云华祠L	清	宋书	帝女 乘鸾 下 碧空 ， 曾闻 佐 禹P 奏 天功 。 当年 秘授 元文册 ， 此日 空余 玉蕊宫L 。 云佩 三千 飞 黛雨 ， 霓裳 十二 落 丹枫 。 江山 自是 多 佳丽 ， 不信 飘零 入 梦中 。
巫峡L 中 望 十二峰L	清	王士禛	十二峰L 绢纱 ， 轻舟 望 是非 。 青天 半 云雨 ， 夕日 乱 烟霏 。 瀑水 临江 合 ， 神鸦 出洞 飞 。 朝云 无 处所 ， 应待 楚王P 归 。
巫峡L	清	许儒龙	放舟 下 巫峡L ， 心 在 十二峰L 。 云山 互 亏蔽 ， 苍翠 难 形容 。 奇峭 无 穷极 ， 人兽 两 绝踪 。 古人 有 佳咏 ， 欲赋 难 为 工 。
巫山L 早发	清	刘曙	峡口 鸣榔 接 晓钟 ， 岭云 无尽 树 重重 。 纵提 彩笔 三千尺 ， 难画 巫山十二峰L 。 尽日 波涛 穿 赤甲 ， 当年 疏凿 仗 黄龙P 。 自从 赋过 高唐L 后 ， 神女 而今 不 再逢 。
过 楚宫L	唐	李商隐	巫峡L 迢迢 旧 楚宫L ， 至今 云雨 暗 丹枫 ， 微生 尽恋 人间 乐 ， 只有 襄王P 忆 梦中 。
清平调词 三首之一	唐	李白	一枝 红艳 露 凝香 ， 云雨 巫山L 枉 断肠 。 借问 汉宫 谁 得似 ， 可怜 飞燕P 倚 新妆 。
谒 巫山庙L	唐	薛涛	乱猿 啼处 访 高唐L ， 路入 烟霞 草木 香 。 山色 未能 忘 宋玉P ， 水声 犹是 哭 襄王P 。 朝朝 夜夜 阳台 下 ， 为云 为雨 楚国L 亡 。 惆怅 庙前 多少 柳 ， 春来 空斗 画眉 长 。
宿 巫山L 寄 远人	唐	梁琼	巫山L 云 ， 巫山L 雨 。 朝云 暮雨 无 定所 ， 南峰 忽暗 北峰 晴 。 空里 仙人 语笑 声 ， 曾待 荆王P 枕席 处 。 忆得 此中 与君 别 ， 感物 情怀 如 旧时 。 君 今 渺渺 在 天涯 ， 晓看 襟上 泪流 处 。
巫山 神女庙L	唐	刘禹锡	星河 好夜 闻 清佩 ， 云雨 归时 带 异香 。 何事 神仙 九天 上 ， 人间 来 就 楚襄王P ？
蜀道L 难	唐	李白	噫 吁 唏 ， 危 乎 高 哉 ， 蜀道L 之 难 难于 上 青天 ， 蚕丛 及 鱼凫 ， 开国 何 茫然 ， 尔来 四万 八千岁 ， 不与 秦塞L 通 人烟 。 畏途 巉岩 不可 攀 ， 但见 悲鸟 号 古木 ， 雄飞 雌从 绕 林间 ， 又 闻 子规 啼 夜月 ， 愁 空山 。 蜀道L 之 难 难于 上 青天 ， 使人 听此 凋 朱颜 。
送 友人 入蜀	唐	李白	见说 蚕丛路L ， 崎岖 不易 行 。 山从 人面 起 ， 云傍 马头 生 。 芳树 笼 秦栈 ， 春流L 绕 蜀城L 。 升沉 应 已定 ， 不必 问 君平P 。
焦崖阁L	唐	韦庄	李白P 曾歌 《 蜀道难 》 ， 长闻 白日 上 青天 。 今朝 夜 过 焦崖阁L ， 始 信 是 河 在 马前 。
蜀道L 难	唐	李白	剑阁 峥嵘 而 崔嵬 ， 一夫 当关 ， 万夫 莫开 。 所守 或 匪亲 ， 化为 狼 与 豺 。 朝避 猛虎 ， 夕避 长蛇 ， 磨牙 吮血 ， 杀人 如麻 。 锦城L 虽 云乐 ， 不如 早 还家 。 蜀道L 之难 难于 上 青天 ， 侧身 西望 长 咨嗟 。
剑门L	唐	杜甫	惟天 有 设险 ， 剑门L 天下 壮 。 连山 抱 西南 ， 石角 皆 向北 。 两岸 崇墉 倚 ， 刻画 城郭 状 。 一夫 怒 临关 ， 百万 未 可傍 。
剑门关L	宋	陆游	剑门L 天 设险 ， 北向 控 函秦L 。 客主 固 殊势 ， 存亡 终 在人 。 栈云 寒 欲 雨 ， 关柳 暗 知春 。 羁客 垂垂老 ， 凭高 一 怆神 。
剑阁L	清	王佶	刀仞 金城L 筑 不全 ， 中留 一线 走 西川L 。 雄关 渴口 先 吞 蜀L ， 乱石 排牙 欲 啮天 。 止恶 周秦T 夸 地利 ， 空劳 李杜P 送 诗篇 。 将军 莫说 泥丸 塞 ， 多少 降旗 插 上边 ？
桂湖L 曲 送 胡孝思P	明	杨慎	君来 桂湖L 上 ， 湖水 生 清风 。 清风 如 君怀 ， 洒然 秋期 同 。 君去 桂湖L 上 ， 湖水 映 明月 。 明月 如 怀君 ， 怅然 何时 辍 。 湖风 向客 清 ， 湖月 照人 明 。 别离 俱 有忆 ， 风月 重 含情 。 含情 重 含情 ， 攀留 桂 之 树 。 珍重 一枝 才 ， 留连 千里 句 。 明年 桂花 开 ， 君 在 雨花台L 。 陇禽 传语 去 ， 江鲤 寄书 来 。
疏江亭L 观 新修 都江堰L	明	杨慎	疏江亭L 上 眺 芳春 ， 千古 离堆 迹 未陈 。 矗矗 楼台 笼 蜃气 ， 㽦㽦 原隰 接 龙鳞 。 井居 需养 非 秦政 ， 则堰 淘滩 是 禹神P 。 为喜 灌坛 河润 远 ， 恩波 德水 又 更新 。
登 甲秀楼L	清	鄂尔泰	炊烟 卓午 散 青丝 ， 十万 人家 饭熟 时 。 闻讯 何年 招 济火 ？ 斜阳 满树 武乡祠L 。
甲秀楼L 即事 偶咏	清	吴达善	甲秀楼L 也 曲径 幽 ， 绿杨 夹水 荡 渔舟 。 而今 回忆 当年 事 ， 风景 苍苍 我 白头 。
扶峰山L	清	郑珍	扶峰山L ， 在 城东 ， 插天 一朵 青芙蓉 。 上下 蜂房 著 芙足 ， 春来 车马 如 游蜂 。 俯视 城郭 销 我 忧 ， 烟花 十里 烂 不收 。
白水瀑布L	清	郑珍	断岩 千尺 无 去处 ， 银河 欲转 上天 去 。 水仙 大笑 且莫 莫 ， 恰好 借渠 写 吾乐 。 白水瀑布L 信 奇绝 ， 占断黔中L 山水 窟 。 世无 苏李P 两 谪仙 ， 江月 海风 谁 解说 。 春风 吹上 观瀑 亭 ， 高岩 深谷 恍 曾经 。 手挹 清泠 洗凡 耳 ， 所 不 同心 如 白水 。
白水河L 观 瀑布	明	潘驯	百尺 铪砑 挂 玉虹 ， 飞涛 溅沫 两 溟淳 。 散为 雨气 侵晴 处 ， 激作 雷声 响雪 中 。 潮上 钱塘L 无此 壮 ， 河倾 碧落 几时 空 ？ 坐来 神骨 无 何有 ， 消尽 寒岩 一壑 风 。
怀阳洞L	清	郑珍	西出 关门囤L ， 路似 循舌 下 尾闾 。 中有 怀阳洞L ， 仰人 呀空 启 龙胡 。 我行 长啸 入 其中 ， 负壁 肃立 伟 丈夫 。 孔雀 惊人 竦 羽翼 ， 白虎 倒喷 苍龙 逋 。 海山 真官 四五 下 ， 踏云 没足 端 以 舒 。 不知 何者 报 我 至 ， 严饰 万象 先 须 吾 。 细视 皆 乃 石髓 成 ， 矫观 中顶 更 绝殊 。 小夫人 乳数 百道 ， 乳头 一一 仙草 敷 。 万古 不受 雨露 恩 ， 元气 往来 翠 不枯 。 半世 看山 此回 苦 ， 风炎 道险 愁 仆痡 。 因 难得 妙若 有悟 ， 一觉 压扁 青 蟾蜍 。 梦回 熨眼 笋 将去 ， 苍苍 落日 趋 前途 。
二月二十七T 度 娄山关L	清	郑珍	山势 西来 万马 奔 ， 大娄L 一勒 九旗屯 。 天随 路人 藤蔓 峡 ， 人共 云争 虎豹门 。 旧日 刘兵P 率 飞过 ， 六年 黔国L 任 翻倾 。 黄心 无复 将军 树 ， 空逐 流移 泫 石根 。
娄山关L	清	杨文照	天险 分 黔蜀L ， 曾经 筑 将坛 。 杀机 成败 定 ， 武备 古今 难 。 劫火 仓皇 起 ， 丸泥 破碎 看 。 乱山 愁 立马 ， 阴月 夕 漫漫 。
移 金马L 碧鸡L 颂	西汉	王褒	处南 之 荒 ， 深溪 回谷 ， 非土 之 乡 ， 归来 ！ 归来 ！ 汉T 德 无疆 ， 广乎 唐虞T ， 泽配 三皇 。 黄龙 见 兮 白虎 仁 ， 归来 ！ 归来 ！ 可以 为 伦 。 归 兮 ！ 翔 兮 ！ 何事 南荒 也 ！
题 筇竹寺L 壁	元	郭松年	南来 作使 驻 征鞍 ， 风景 还惊 入画 看 。 梵宇 云埋 筇竹 老 ， 滇池 霜浸 碧鸡L 寒 。 兵威 此日 虽 同轨 ， 文德L 他年 见 舞干 。 北望 乌台L 犹 万里 ， 几回 挥泪 惜 凋残 。
高峣L 泛舟	明	李元阳	不到 昆明L 三十年 ， 重来 今日 已 皤然 。 担头 诗卷 半挑 酒 ， 水上 人家 都 种莲 。 山色 满湖 能 不醉 ？ 荷香 十里 欲 登仙 。 碧鸡L 岩畔 堪 题字 ， 好把 滇池L 取次 镌 。
登 太华寺L	明	张紞	太华L 嵯峨 一 望遥 ， 到门 犹疑 过 鹊桥 。 慈云 常见 阶前 起 ， 孽火 都来 海上 消 。 屋近 树阴 晴 亦 暗 ， 砚涵 竹露 夜 还潮 。 从今 愿买 游 山屐 ， 野客 无妨 屡见 招 。
望 西山L	清	孙鹏	满楼 山 屹屼 ， 好是 美人峰L 。 眉黛 翠 双锁 ， 髻螺 云儿 重 。 二姑 开 晓镜 ， 五老 望 朝容 。 笑尔 多情 者 。 春来 色 倍浓 。
碧鸡关L 晚眺 有怀	清	段昕	碧鸡L 高峙 海波 平 ， 暮色 苍茫 万感 生 。 太史 声华 新 寝庙 ， 黔宁P 家业 归 金城L 。 半天 风雨 鱼龙 梦 ， 几度 沧桑 草木 兵 。 为语 汉时 持节 者 ， 不须 望祠 到 昆明L 。
春晓T 望 太华山L	清	戴絧孙	镵天 数点 高峰 出 ， 曈曈 晓镜 上 初日 。 迥风 吹逐 岫云 孤 ， 山光 倒入 昆明湖L 。 绿萝 何处 梁王宫L ， 沐浦 桃花 锦浪 中 。 会凌 绝顶 眺 城廓 ， 俯视 一气 青濛濛 。
冒雨 游 圆通山L	清	杨履宽	名山 如 美人 ， 好雨 如 膏沐 。 当秋 一 溟濛 ， 眉黛 染 深绿 。 偶来 纵情 眺 ， 新翠 近 可掬 。 蹬道 石 盘旋 ， 苔深 屐 踯躅 。 摄衣 更 登临 ， 千松 万松 簇 。 回首 昆明L 池 ， 烟波 正 相逐 。
过 圆通寺L 怀 孙髯翁L 先生	清	师范	日日 看山 不 出城 ， 夕阳 秋雨 可怜 生 。 咒蛟 台上 松风 冷 ， 犹为 孙登P 起 啸声 。
华亭L 春茶	清	孙髯	可惜 山茶 云锦 被 ， 雪天 开到 暮春T 时 。 赤球 绿甲 攒 高树 ， 大朵 细心 压 软枝 。 第是 名园 争 载酒 ， 即教 海客 亦 相思 。 华亭寺L 隔 盈盈水 ， 十丈 明霞 何处 垂 。
滇池L 赤藤杖 歌	唐	韩愈	赤藤 为杖 世 未 窥 ， 台郎 始携 自 滇池L 。 滇王P 扫宫 避 使者 ， 跪进 再拜 语 嗢咿 。 途经 百国 皆 奠识 ， 君臣 聚观 逐 旌麾 。 共传 滇神 出水 献 ， 赤龙 拔须 血 淋漓 。 归来 捧赠 同 舍子 ， 浮光 照手 欲 把 疑 。 妍辞 丽句 不可 继 ， 见 寄聊 且 慰 分司 。
滇池L 赋	元	王升	探 华亭L 之 幽趣 ， 登 太华L 之 层峰 。 觅 滇南L 之 胜概 ， 指 八景 之 陈踪 。 碧鸡L 峭拔 而 岌 ， 金马L 逶迤 而 玲珑 。 双塔 挺 擎天 之 势 ， 一桥 横贯 日 之 虹 。 千艘 蚁聚 于 云津L ， 万舶 蜂屯 于 城垠 。 如此 池 之 趋海 兮 ， 亘 书夜 之 靡停 。 因而 歌 曰 ： 万派 朝宗 兮 ， 海宇 穹窿 。 圣神 膺运 兮 ， 车书 大同 。
昆阳L 望海	明	杨慎	昆明L 波涛 南纪L 雄 ， 金碧 滉漾 银河 通 。 平吞 万里 象马国 ， 直下 千尺 蛟龙宫 。 天外 烟峦 分 点缀 ， 云中 海树 入 空濛 。 乘槎 破浪 非 无事 ， 已斩 鱼竿 狎 钓翁 。
滇海L 曲 十二首 （ 之二 ）	明	杨慎	碧鸡L 金马L 古 梁州L ， 铜柱 铁桥 天际 头 。 试问 平滇L 功 第一 ， 逢人 惟说 颍川侯P 。
滇海L 曲 十二首 （ 之三 ）	明	杨慎	苹香 波暖 泛 云津L ， 渔枻 樵歌 曲 水滨 。 天气 常如 二三月 ， 花枝 不断 四时 春 。
春望 三首 （ 之二 ）	明	杨慎	古岸 新花 金碧 丛 ， 昆池L 三百 水烟 通 。 梁王 阁道 青芜 国 ， 渔父 帆樯 白鸟 飞 。
滇池L 夜月	明	机先	滇池L 有客 夜 乘舟 ， 渺渺 金波 接 素秋 。 白月 随人 相 上下 ， 青天 在水 与 沉浮 。 遥怜 谢客 沧州L 趣 ， 更爱 苏生 赤壁L 游 。 坐 依 蓬窗 吟 到 晓 ， 不知 身 尚 在 南州L 。
龙门L 赠 吴道人P	清	那文凤	万钻 千椎 显 巨才 ， 悬岩 陡处 辟 仙台 。 何须 佛洞 天生 就 ， 直赛 龙门L 禹P 凿开 。 紫竹 藤书 心里 出 ， 慈云 霭露 掌中 来 。 昆池L 恰似 观 南海L ， 不负 当年 梦 几回 。
登 晋宁L 望海楼	清	师问忠	望海楼 头 望 ， 沧波 万顷 长 。 凿 应 嗤 武帝P ， 溺 却 吊 梁王P 。 舟去 移 山影 ， 天来 接 水光 。 石鲸 鳞甲 在 ， 把酒 意 茫茫 。
题 大观楼L 二首	清	赵藩	近华浦L 上 大观楼L ， 高压 滇南L 十四州 。 此日 筹边 何 限事 ， 凭栏 无语 对 闲鸥 。 掀翻 蒙段 劫 余灰 ， 金碧 丹青 壮丽 开 。 都在 髯翁P 凭 吊里 ， 更谁 楼上 赋诗 来 。
游 城东 鹦鹉山L 太和宫L 铜殿 ， 见 吴三桂P 所遗 刀剑 各纪 一律	清	王堃	剸犀 研兕 仗 神豪 ， 传说 平西L 铁 宝刀 。 半段 那如 舒翰P 戟 ， 一枝 空认 彦章P 蒿 。 剪仇 峰冠 三藩 勇 ， 跋扈 尘飞 贰 负嚣 。 双喜 白龙桥L 下 队 ， 虫沙 何处 觅 乌韬 。
圆圆P 曲	明	吴伟业	鼎湖L 当日 弃 人间 ， 破敌 收京 下 玉关L 。 恸哭 六军 俱 缟素 ， 冲冠 一怒 为 红颜 。 若非 壮士 全师 胜 ， 争得 蛾眉 匹马 还 。 妻子 岂应 关 大计 ， 英雄 无奈 是 多情 。 全家 白骨 成 灰土 ， 一代 红妆 照 汗青 。 君不见 馆娃 初起 鸳鸯宿 ， 越女 如花 看不足 。 香径L 尘生 乌 自啼 ， 屟廊 人去 苔 空绿 。 换羽 移宫 万里 愁 ， 珠歌 翠舞 古梁州L 。 为君 别唱 吴宫 曲 ， 汉水 东南 日夜 流 。
黑龙潭L 观梅	清	马之龙	我本 雪山 客 ， 今年 始 出游 。 相寻 有 梅树 ， 高卧 向 龙湫L 。 昨夜 苔 封径 ， 终朝 笛 倚楼 。 盘桓 当 岁暮 ， 不复 动 乡愁 。
游 黑龙潭L 看 唐梅 二律	清	阮元	千岁 梅花 千尺 潭 ， 春风 先到 彩云南L 。 香吹 蒙凤P 龟兹 笛 ， 影伴 天龙 石 佛龛 。 玉斧 曾遭 图外 划 ， 骊珠 常向 水中 探 。 只嗟 李杜P 无 题句 ， 不与 逋仙P 季迪P 谈 。 铁石 心肠 宋开府P ， 玉冰 魂魄 古 梅花 。 边功 自坏 鲜于P 手 ， 仙树 遂归 南诏L 家 。 今日 太平 多 雨露 ， 当年 万里 隔 烟霞 。 老龙 如见 三 沧海 ， 试与 香林 较 岁华 。
石林L	清	何彤云	入望 忽 森森 ， 苍然 石气 深 。 插天 青玉 笏 ， 堕地 碧 瑶簪 。 长讶 镡 千尺 ， 低犹 笋 一寻 。 不逢 元镇P 画 ， 狮子 独名林 。
点苍L 临眺	元	李京	水绕 青山 山 绕城 ， 万家 烟火 一川 明 。 鸟 从 云母屏 中 过 ， 鱼 在 鲛人镜 里 行 。 翡翠 罘罳 笼 海气 ， 旃檀 楼阁 殷 秋声 。 虎头P 妙墨 龙眠L 手 ， 百㡧 生绡 画 不成 。
题 苍山L	清	许毂	点苍山L 高 高插 空 ， 灵光 直射 井鬼宫L 。 地轴 摇开 三百里 ， 天险 横分 十九峰 。 此山 隆峻 不可 蹑 ， 群峰 丘吐 琼瑶 色 。 朱夏T 长吟 六月T 风 ， 苍岩 独照 千秋 雪 。 岩上 高河L 镜 四周 ， 川川 喷雪 溅 珠玑 。 元波 万顷 蛟龙 卧 ， 白日 一呼 风雨 飞 。
人月圆 泛 大理海子L	明	杨慎	好风 雨日 相 迎送 ， 渺渺 碧波 平 。 玉几L 云凭 ， 金梭L 烟织 ， 宝刹 霞明 。 邀散 神仙 ， 寻闲 洲岛 ， 上小 蓬瀛L 。 海流 东逝 ， 海天 南望 ， 海月 西生 。
观 南诏碑L 有感	清	宋湘	此碑 谁 所为 ， 苦心 多 慷慨 。 道是 西泸令P ， 郑回P 能 文章 。 阳叙 一战 烈 ， 阴设 千秋 防 。 叛唐 非 得已 ， 字字 含 风霜 。
拉萨招L	清	和瑛	万里 乌斯藏L ， 千层 拉萨招L 。 班禅P 参 妙喜 ， 达赖P 脱 尘嚣 。 叩额 诸蕃 控 ， 雕题 百貊 朝 。 家家 唐古特 ， 别蚌 属 庭枭 。
曲水塘L	清	松筠	曲水L 即 渚湑L ， 汉音 非 蛮语 。 关隘 依 岩道 ， 江岸 环 幽圉 。 形似 阵长 蛇 ， 是谓 百夫 御 。 岂独 地势 佳 ， 随在 多 粮糈 。 且喜 近 前招L ， 程 仅 两日 许 。 欲见 乐 升平 ， 治 以 同胞 与 。 惟期 善时 保 ， 万载 堪 宁处 。
大昭寺L	清	孙士毅	宝相 庄严 玉 辟邪 ， 虚传 神女 到 天涯 。 燕支L 关塞 相恩果 ， 金碧 楼台 称意 花 。 台高 有林 开 鹿苑 ， 琵琶 无语 怨 龙沙 。 定昆池畔L 灰 犹熟 ， 阅尽 恒河 几岁 华 。
江孜L	清	松筠	秋阅 江孜L 汎 ， 蛮戎 演战 图 。 炮声 发震 日 ， 鼓气 跃 争驱 。 锐技 惟 蝥进 ， 雄师 在 令呼 。 百年 虽 不用 ， 一日 未应 无 。 训练 能 循制 ， 屏藩 足 镇隅 。 赏颁 嘉 壮健 ， 感激 饮 醍醐 。
扎什伦布L	清	文干	岩山L 镇 琳宫L ， 高标 倚 碧空 。 滦阳L 瞻 梵宇 ， 结构 此间 同 。 此地 临 西极L ， 诸天 演 上乘 。 乌斯L 开 法界 ， 游历 记 吾 曾 。
古风 其十九	唐	李白	西上 莲花山L ， 迢迢 见 明星 。 素手 把 芙蓉 ， 虚步 蹑 太清 。 霓裳 曳广带 ， 飘拂 升天 行 。 邀我 登 云台L ， 高揖 卫叔 卿 。 恍恍 与之 去 ， 驾鸿 凌 紫冥 。 俯视 洛阳L 川 ， 茫茫 走 胡兵 。 流血 涂 野草 ， 豺狼 尽 冠缨 。
西岳L 云台L 歌送 丹丘子P	唐	李白	西岳L 峥嵘 何 壮 哉 ， 黄河L 如丝 天际 来 。 黄河L 万里 触山 动 ， 盘涡 毂转 秦地 雷 。 巨灵 咆哮 擘 两山 ， 洪波 喷流 射 东海L 。 三峰 却立 如 欲摧 ， 翠屏 丹谷 高掌 开 。
华岳L	唐	王维	西岳L 出 浮云 ， 积雪 在 太清 。 连天 凝黛 色 ， 百里 遥 青冥 。 白日 为之 寒 ， 森沉 华阴 城 。 昔闻 乾坤 闭 ， 造化 生 巨灵 。 右足 踏方 止 ， 左手 推削 成 。 天地 忽 开坼 ， 大河 注 东溟L 。 遂 为 西峙岳L ， 雄雄 镇 秦京L 。
望 岳	唐	杜甫	西岳L 崚嶒 竦处 尊 ， 诸峰 罗立 如 儿孙 。 安得 仙人 九节杖 ， 拄到 玉女 洗头盆 。 车箱 入谷 无归 路 ， 箭栝 通天 有 一门 。 稍待 西风 凉冷 后 ， 高寻 白帝L 问 真源 。
途经 华岳L	唐	李隆基	饬驾 去 京邑L ， 鸣鸾 指 洛川L 。 循途 经 太华L ， 回跸 蹔 周旋 。 翠萼 留 斜影 ， 悬崖 凝 夕烟 。 四方 皆 石壁 ， 五位 配 金天 。 仿佛 看 高掌L ， 依稀 听 子先P 。 终当 铭 岁月 ， 从此 记灵仙 。
华山L	唐	张乔	青苍河 一隅 ， 气状 杳难 图 。 卓杰 三峰 出 ， 高奇 四岳 无 。 鹤归 青霭 合 ， 仙去 白云 孤 。 瀑漏 斜飞 冻 ， 长松 倒挂 枯 。 每 来 探 洞穴 ， 不拟 返 江湖 。 倘有 芝田 种 ， 商岩L 老一夫 。
经 太华L	唐	卫光一	太华L 五千寻 ， 重岩 合沓 起 。 势飞 白云 外 ， 影倒 黄河L 里 。 上有 千莲叶 ， 服之 久 不死 。 山高 采 难得 ， 叹息 徒 仰止 。
望 岳	清	李因笃	太华L 三峰 列 峻屏 ， 晴霄 飞翠 下 空溟 。 晓云 东抱 关河L 紫 ， 秋色 西来 天地 青 。 玉女盆L 中 寒 落黛 ， 仙人掌 上 接 明星 。 乱余 林壑 饶 遗客 ， 缥缈 幽栖 赋 采芩 。
行经 华阴L	唐	崔颢	岧峣 太华L 俯 咸京L ， 天外 三峰 削 不成 。 武帝祠L 前 云 欲散 ， 仙人掌L 上 雨 初晴 。 河山 北枕 秦关L 险 ， 驿树 西连 汉畤 平 。 借问 路旁 名利 客 ， 无如 此处 学长 生 。
古意	唐	韩愈	太华L 峰头 玉井莲L ， 开花 十丈 藕 如 船 。 冷 比 雪霜 甘 比 蜜 ， 一片 入口 沈疴 痊 。 我 欲 求之 不惮 远 ， 青壁 无路 难 夤缘 。 安得 长梯 上 摘实 ， 下种 七泽 根株 连 。
朝阳峰L 仙掌	唐	齐己	峭形 寒倚 夕阳 天 ， 毛女L 莲花L 翠影 连 。 云外 自为 高 出手 ， 人间 谁 合 斗 挥拳 。 鹤 抛 青汉 来 岩桧 ， 僧隔 黄河L 望 顶烟 。 晴露 红霞 长满 掌 ， 只应 栖托 是 神仙 。
杪秋T 登 太华山L 绝顶	明	李攀龙	缥缈 真探 白帝宫L ， 三峰 此日 为谁 雄 。 苍龙 半挂 秦川L 雨 ， 石马 长嘶 汉苑 风 。 地敞 中原L 秋色 尽 ， 天开 万里 夕阳 空 。 平生 突兀 看 人意 ， 容尔 深知 造化 功 。
华峰顶	清	潘耒	昆仑L 之脉 从天 来 ， 散作 岳镇 千琼 瑰 。 帝怒 东南 势 倾斜 ， 特耸 一柱 名 天台L 。 天台L 环周 五百里 ， 金翅 擘翼 龙 分胎 。 峰峦 一一 插 霄汉 ， 涧瀑 处处 奔 虹雷 。 华顶L 最高 透 天顶 ， 万八 千丈 青 崔嵬 。 乘云 驭风 或 可上 ， 我 忽 到之 亦 神哉 。
感 赵宗印P 事	宋	陆游	我梦 游 太华L ， 云开 千仞 青 。 擘山 泻 黄河L ， 万古 仰 巨灵 。 将军 散发 去 ， 短剑 㔉 茯苓 。 定知 三峰 上 ， 烂醉 今 未醒 。
十八盘L	明	王时雍	华岳L 高 千丈 ， 登临 路 转盘 。 石梯 偏 碍马 ， 山木 易 捎冠 。 雨过 岩花 净 ， 云开 眼界 宽 。 峰头 游 罢看 ， 余兴 尚 漫漫 。
西峰L	宋	陈抟	为爱 西峰L 好 ， 吟头 尽日 昂 。 岩花 红 作诗 ， 溪水 绿 成行 。 几夜 碍 新月 ， 半山 无 斜阳 。 寄言 嘉 遁客 ， 此处 是 仙乡 。
回心石	明	袁宏道	华顶L 不高 涧 不深 ， 一回 遗世 一 登临 。 若为 题 向 长安L 道 ， 回却 朱门 紫陌 心 。
苍龙岭	明	袁宏道	瑟瑟 秋涛 谷底 鸣 ， 扶摇 风里 一毛 轻 。 半生 始得 惊 人事 ， 撒手 苍龙岭L 上 行 。
题 云台峰L	明	阎尔梅	山巅 山麓 异 阴晴 ， 群巘 参差 雾 割平 。 落雁峰L 头 云 万丈 ， 飞鱼岭L 上 月 三更 。 星潭 水响 金蕖 舞 ， 箭筈 风摇 铁锁 惊 。 夷险 何常 人 自取 ， 樵夫 担担 走 㠉坪 。
长安L 古意	唐	卢照邻	长安L 大道 连 狭斜 ， 青牛 白马 七香 车 。 玉辇 纵横 过 主第 ， 金鞭 络绎 向 侯家 。 龙衔 宝盖 承朝 日 ， 凤吐 流苏 带 晚霞 。 百尺 游丝 争 绕树 ， 一群 娇鸟 共 啼花 。 游蜂 戏蝶 千门 侧 ， 碧树 银台 万种 色 。 复道 交窗 作 合欢 ， 双阙 连甍 垂 凤翼 。 梁家 画阁 中天 起 ， 汉帝P 金茎 云外 直 。 楼前 相望 不 相知 ， 陌上 相逢 讵 相识 。 节物 风光 不 相待 ， 桑田 沧海 须臾 改 。 昔时 金阶 白玉堂 ， 即今 惟见 青松 在 。 寂寂 寥寥 扬子P 居 ， 年年 岁岁 一床 书 。 独有 南山L 桂花 发 ， 飞来 飞去 袭人 裾 。
阳春L 歌	唐	李白	长安L 白日 照 春空 ， 绿杨 结烟 桑袅 风 。 披香殿L 前 花 始 红 ， 流芳 发色 绣户 中 。 绣户 中 ， 相 经过 。 飞燕皇后P 轻身 舞 ， 紫宫夫人P 绝世 歌 。 圣君 三万六千日 ， 岁岁 年年 奈 乐何 。
饮中 八仙歌	唐	杜甫	知章P 骑马 似 乘船 ， 眼花 落井 水底 眠 。 汝阳P 三斗 始 朝天 ， 恨 不移 封向 酒泉 。 左相P 日兴 费 万钱 ， 饮如 长鲸 吸 百川 。 宗之P 潇洒 美少年 ， 举觞 白眼 望 青天 。 苏晋P 长斋 绣 佛前 ， 醉中 往往 爱 逃禅 。 李白P 一斗 诗 百篇 ， 长安市L 上 酒家 眠 。 天子 呼来 不 上船 ， 自称 臣是 酒中 仙 。 张旭P 三杯 草圣 传 ， 挥毫 落纸 如 云烟 。 焦遂P 五斗 方 卓然 ， 高谈 雄辩 惊 四筵 。
千秋乐	唐	张祜	八月T 平时 花萼楼L ， 万方 同乐 奏 千秋 。 倾城 人看 长竿 出 ， 一伎 初成 赵解愁P 。
踏歌 辞	唐	张说	花萼楼L 南 雨露 新 ， 长安城L 里 太平 人 。 龙衔火树 千灯 艳 ， 鸡踏莲花 万岁 春 。
兵车 行	唐	杜甫	车辚辚 ， 马萧萧 ， 行人 弓箭 各 在 腰 。 爷娘 妻子 走 相送 ， 尘埃 不见 咸阳桥L 。 牵衣 顿足 拦道 哭 ， 哭声 直上 干 云霄 。
城东 早春T	唐	杨巨源	诗家 清景 在 新春 ， 绿柳 才黄 半未 匀 。 若待 上林L 花 似锦 ， 出门 俱是 看花 人 。
寒食T	唐	韩翃	春城 无处 不 飞花 ， 寒食T 东风 御柳 斜 。 日暮 汉宫 传 蜡烛 ， 轻烟 散入 五侯 家 。
哭 晁卿衡P	唐	李白	日本L 晁卿P 辞 帝都 ， 征帆 一片 绕 蓬壶L 。 明月 不归 沉 碧海 ， 白云 愁色 满 苍梧L 。
登 乐游原L 春望 书怀	唐	张九龄	城隅 有 乐游L ， 表里 见 皇州L 。 策马 既 长远 ， 云山 亦 悠悠 。 万壑 青光 满 ， 千门 喜气 浮 。 花间 直城 路 ， 草际 曲江 流 。
忆 秦娥P	唐	李白	箫声 咽 ， 秦娥P 梦断 秦楼月 。 秦楼月 ， 年年 柳色 ， 灞陵L 伤别 。 乐游原L 上 清秋节T ， 咸阳L 古道 音尘 绝 。 音尘 绝 ， 西风 残照 ， 汉家 陵阙 。
乐游原L 霁虹	唐	李商隐	万树 鸣蝉 隔 断虹 ， 乐游原L 上 有 西风 。 羲和P 自趁 虞泉L 宿 ， 不放 斜阳 更 向东 。
乐游原L 春望	唐	李频	五陵 佳气 晚 氤氲 ， 霸业 雄图 势 自分 。 秦地 山河 连 紫塞 ， 汉家 宫殿 入 青云 。 未央L 树色 春中 见 ， 长乐L 钟声 月下 闻 。 无那 杨花 起 秋思 ， 满天 飘落 雪纷纷 。
晨 登 乐游原L 望 终南 积雪	唐	皎然	凌晨 拥 弊裘 ， 径上 古原头 。 雪霁 山 疑近 ， 天高 思 若浮 。 寒空 标 瑞色 ， 爽气 袭 皇州L 。 清眺 何人 得 ， 终当 独 再游 。
丽人 行	唐	杜甫	三月三日T 天气 新 ， 长安L 水边 多 丽人 。 态浓 意远 淑 且 真 ， 肌理 细腻 骨肉 匀 。 就中 云幕 椒房 亲 ， 赐名 大国 虢L 与 秦L 。 后来 鞍马 何 逡巡 ， 当轩 下马 入 锦茵 。 杨花 雪落 复 白苹 ， 青鸟 飞去 衔 红巾 。 炙手 可热 势 绝伦 ， 慎 莫 近前 丞相 瞋 。
曲江L 春望	唐	刘禹锡	凤城L 烟雨 歇 ， 万象 含 佳气 。 酒后 人 倒狂 ， 花时 天 似醉 。 三春T 车马 客 ， 一代 繁华 地 。 何事 独 伤怀 ， 少年 曾 得意 。
曲江L 早春	唐	白居易	曲江L 柳条 渐 无力 ， 杏园 伯劳 初 有声 。 可怜 春浅 游人 少 ， 好傍 池边 下马 行 。
曲江L 池上	唐	雍裕之	殷勤 春在 曲江L 头 ， 全藉 群仙 占胜 游 。 何必 三山 待 鸾鹤 ， 年年 此地 是 瀛洲L 。
龙池L	唐	李商隐	龙池L 赐酒 敞 云屏 ， 羯鼓 声高 众乐 停 。 夜半 宴归 宫漏 永 ， 薛王P 沉醉 寿王P 醒 。
春霁 花萼楼L 南 闻 宫莺	唐	杨凌	祥烟 瑞气 晓 来 轻 ， 柳变 花开 共作 晴 。 黄鸟 远啼 鳷鹊观L ， 春风 流出 凤凰城L 。
勤政楼L 西柳	唐	白居易	半朽 临风 树 ， 多情 立马 人 。 开元T 一株 柳 ， 长庆T 二年 春 。
天宝T 宫词	唐	石瑶	勤政楼L 前 斗 两朋 ， 宁王P 新乐 最 堪听 。 太真P 偏赏 凉州L 曲 ， 自奉 黄金 出 内屏 。
同 诸公 登 慈恩寺塔L	唐	杜甫	高标 跨 苍穹 ， 烈风 无 时休 。 七星 在 北户 ， 河汉 声 西流 。 羲和P 鞭 白日 ， 少昊P 行 清秋T 。 秦山L 忽 破碎 ， 泾渭L 不可 求 。 黄鹄 去 不息 ， 哀鸣 何 所投 。 君看 随阳 雁 ， 各有 稻粱 谋 。
登 长安L 慈恩寺塔L	唐	卢宗回	东方 晓日 上 翔鸾 ， 西转 苍龙 拂 露盘 。 渭水 寒光 摇 藻井 ， 玉峰 晴色 上 朱阑 。 九重 宫阙 参差 见 ， 百二 河山 表里 现 。 暂辍 去篷 悲 不定 ， 一凭 金界L 望 长安L 。
题 雁塔L	唐	许玫	宝轮 金地 压 人寰 ， 独坐 苍冥 启 玉关 。 北岭 风烟 开 魏阙 ， 南轩 气象 镇 商山L 。 灞陵L 车马 垂扬 里 ， 京国L 城池 落照 间 。 暂放 尘心 游 物外 ， 六街 钟鼓 又 催还 。
登 慈恩寺塔L	唐	张乔	窗户 几层 风 ， 清凉 碧落 中 。 世人 来往 别 ， 烟景 古今 同 。 列岫 横 秦断 ， 长河L 极 塞空 。 斜阳 越 乡思 ， 天末 见 归鸿 。
慈恩寺L 上 雁塔L	清	洪亮吉	忆 从 初地 擅 名扬 ， 阅劫 来游 竟 渺茫 。 韦曲L 花深 愁 暮雨 ， 终南山L 古 易 斜阳 。 高张岑杜P 诗篇 冷 ， 天宝开元T 岁月 荒 。 莫笑 众贤 易 名朽 ， 塔前 杯水 已 沧桑 。
灞陵L 行 送别	唐	李白	送君 灞陵亭L ， 灞水L 流浩浩 。 上有 无花 之 古树 ， 下有 伤心 之 春草 。 我向 秦人 问 路岐 ， 云是 王粲P 南登 之 古道 。 古道 连绵 走 西京L ， 紫阙 落日 浮云 生 。 正当 今夕 断肠 处 ， 黄鹂 愁绝 不忍 听 。
灞岸L 别友	唐	戴叔伦	车马 去 迟迟 ， 离言 未 尽时 。 看花 一 醉 别 ， 会面 几年 期 。 樵路 高山 馆 ， 渔洲L 楚帝祠L 。 南登 回首 处 ， 犹得 望 京师L 。
灞桥L 寄内	清	王士祯	太华L 钟南L 万里 遥 ， 西来 无处 不 魂销 。 闺中 若问 金钱 卜 ， 秋雨 秋风 过 灞桥L 。
登 骊山L 瞩目	唐	张说	寒山 上 半空 ， 临眺 尽 寰中 。 是日 巡游 处 ， 晴光 远近 同 。 川明 分 渭水L ， 树暗 辨 新丰L 。 岩壑 清音 暮 ， 天歌 起 大风 。
和 太常 韦主簿L 温汤 寓目	唐	王维	汉主离宫L 接 露台 ， 秦川L 一半 夕阳 开 。 青山 尽是 朱旗 绕 ， 碧涧 翻从 玉殿 来 。 新丰L 树里 行人 度 ， 小苑 城边 猎骑 回 。 闻道 甘泉 能 献赋 ， 悬知 独有 子云P 才 。
骊山L 绝句	宋	苏轼	功成 虽善 欲 持盈 ， 可笑 前王 恃 太平 。 辛苦 骊山L 山下 土 ， 阿房L 才废 又 华清L 。 几度 雕墙 几变 灰 ， 举烽 指鹿 事 悠哉 。 上皇 不念 前车 戒 ， 却怨 骊山L 是 祸胎 。 海中 方士 觅 三山 ， 万古 明知 去 不还 。 咫尺 秦陵 是 商鉴 ， 朝元L 何必 苦 跻攀 。
夜 梦游 骊山L	唐	陆游	秦楚T 相望 万里 天 ， 岂知 今夕 宿 温泉 。 穿云 潄月 无穷 恨 ， 依旧 潺湲 古县L 前 。
过 骊山L	金	陈规	丰镐L 无由 问 故基 ， 三章 止见 《 黍离 》 诗 。 而今 多少 华清石 ， 都与 行人 刻 艳词 。
温泉	元	宋子贞	骊山L 山下 水粼粼 ， 曾浴 华清L 第一人 。 云窦 暗通 金屋 暖 ， 月波 常浸 玉莲 春 。 应藏 褒姒P 千年 火 ， 不洗 渔阳L 万马 尘 。 安得 汤盘 铭 九字 ， 明明 盛德 日 维新 。
温泉	元	魏起	泉源 云暖 碧粼粼 ， 火井 暗通 地 入秦 。 一酌 已消 神女 唾 ， 千秋 难洗 羯奴 尘 。 山连 太白L 空 多雪 ， 池 到 华清L 别有 春 。 莫向 此中 谈 往事 ， 芙蓉 杨柳 亦 伤神 。
骊山L 怀古	元	商挺	女色 迷人 祸 更长 ， 千年 烽火 化 温汤 。 无情 一片 骊山L 月 ， 照罢 周家 又到 唐 。
温泉	明	杨慎	天宝T 繁华 迹 已陈 ， 朝元阁L 上 玉 嶙峋 。 山头 寒树 深埋 雪 ， 池面 温汤 别 贮春 。 歌舞 声留 供奉 曲 ， 珮环 魂断 属车 尘 。 可怜 一片 离宫 月 ， 曾照 当时 同 辇人 。
骊山L 咏	明	刘球	一片 秦京L 最好 山 ， 离宫 没后 古碑 残 。 涓涓 惟有 温泉 水 ， 流到 如今 尚不 寒 。
过 华清宫L 浴汤泉	明	袁宏道	十六长汤 院 ， 阿谁 似 玉环 ？ 故宫 秋草 里 ， 小邑 水声 间 。 童子 驱羊 去 ， 村姑 赛庙 还 。 教他 杨广P 笑 ， 破国 只 骊山L 。
过 骊山L	清	杨树椿	驱马 栎阳L 道 ， 当年 辇路 通 。 香泉 温 绣岭L ， 细雨 湿 新丰L 。 松柏 非 秦树 ， 山河 自 汉宫 。 前朝 无限 事 ， 秋霭 暮烟 中 。
长恨歌	唐	白居易	汉皇 重色 思 倾国 ， 御宇 多年 求 不得 。 杨家 有女 初 长成 ， 养在 深闺 人 未识 。 天生 丽质 难 自弃 ， 一朝 选在 君王 侧 。 回眸 一笑 百媚 生 ， 六宫 粉黛 无 颜色 。 春寒 赐浴 华清池L ， 温泉 水滑 洗 凝脂 。 侍儿 扶起 娇 无力 ， 始是 新承 恩泽 时 。 春宵 苦短 日 高起 ， 从此 君王 不 早朝 。 后宫 佳丽 三千人 ， 三千 宠爱 在 一身 。 姊妹 兄弟 皆 列土 ， 可怜 光彩 生 门户 。 遂令 天下 父母 心 ， 不重 生男 重 生女 。 骊宫L 高处 入 青云 ， 仙乐 风飘 处处 闻 。 渔阳L 鞞鼓 动地 来 ， 惊破 霓裳 羽衣 曲 。
华清宫L	唐	张籍	温泉 流入 汉离宫L ， 宫树 行行 浴殿 空 。 武帝P 归时 人 欲尽 ， 青山 空闭 御墙 中 。
华清宫L	唐	张继	天宝T 承平 奈 乐何 ， 华清宫殿L 郁 嵯峨 。 朝元阁L 峻 临 秦岭L ， 羯鼓楼L 高 俯 渭河L 。 玉树 长飘 云外 曲 ， 霓裳 闲舞 月中 歌 。 只今 惟有 温泉 水 ， 呜咽 声中 感慨 多 。
华清宫L	唐	李商隐	华清L 恩幸 古 无伦 ， 犹恐 娥眉 不胜 人 。 未免 被他 褒女 笑 ， 只教 天子 暂 蒙尘 。
过 华清宫L 绝句	唐	杜牧	长安L 回望 绣 成堆 ， 山顶 千门 次第 开 。 一骑 红尘 妃子 笑 ， 无人 知是 荔枝 来 。 新丰L 绿树 起 黄埃 ， 数骑 渔阳L 探使 回 。 霓裳 一曲 千峰 上 ， 舞破 中原 始 下来 。
华清宫L	唐	吴融	渔阳L 烽火 照 函关L ， 玉辇 匆匆 下 此山 。 一曲 羽衣 听 不尽 ， 至今 遗恨 水潺潺 。 别殿 和云 锁 翠微 ， 太真P 遗像 梦 依依 。 上皇 揜泪 频 惆怅 ， 应叹 僧繇P 彩笔 飞 。
绣岭宫L 词	唐	李洞	春日 迟迟 春草 绿 ， 野棠 开尽 飘香 玉 。 绣岭宫L 前 鹤发翁 ， 犹唱 开元T 太平曲 。
华清宫L	清	沈兆霖	迷离 绣岭L 锁 云鬟 ， 喷薄 汤泉 送 珮环 。 惯阅 兴亡 惟 此水 ， 自耽 安乐 不由 山 。 醮坛 初日 朝元阁L ， 蜀栈 悲风 大散关L 。 珠殿 只今 余 废础 。 合欢 皂荚 有 谁 攀 。
华清宫L	清	舒位	骊山L 汤殿 古 华清L ， 只洗 凝脂 不 洗兵 。 一自 波澜 流 祸水 ， 至今 风雨 作 秋声 。 新蒲 细柳 江头 闭 ， 暮草 幽花 辇路 平 。 别馆 离宫 三十六 ， 不须 烽火 也 倾城 。
终南山L	唐	王维	太乙L 近 天都 ， 连山 接 海隅 。 白云 回望 合 ， 青霭 入看 无 。 分野 中峰 变 ， 阴晴 众壑 殊 。 欲投 人处 宿 ， 隔水 问 樵夫 。
翠微寺L 二首 其一	金	赵秉文	南山L 常怀 退之L 诗 ， 未说 云烟 润色 之 。 要见 山光 如 泼黛 ， 更须 留待 雨晴 时 。
翠微寺L 二首 其二	金	赵秉文	南山L 深锁 翠微宫L ， 寺 在 山南 十里 东 。 祇怪 朝来 衫袖 湿 ， 不知 身在 翠微L 中 。
秋日 登 西城L 望 终南L 诸峰	明	康万民	岸帻 凭栏 眺 远峰 ， 氤氲 佳气 散 芙蓉 。 欲登 瀛海L 三山 岛 ， 安得 仙人 九节 筇 。 紫塞 夜寒 归 候雁 ， 昆明L 秋老 隐 游龙 。 家贫 性僻 惟 耽酒 ， 痛饮 能追 五柳P 踪 。
古风 五十九首 之一	唐	李白	秦皇L 埽 六合 ， 虎视 何 雄哉 ！ 挥剑 决 浮云 ， 诸侯 尽 西来 。 明断 自 天启 ， 大略 驾 群才 。 收兵 铸 金人 ， 函谷L 正 东开 。 铭功 会稽岭L ， 骋望 瑯邪台L 。 刑徒 七十万 ， 起土 骊山L 隈 。 尚采 不死药 ， 茫然 使 心哀 ！ 徐市 载 秦女 ， 楼船 几时 回 ？ 但见 三泉 下 ， 金棺 葬 寒灰 ！
幸 秦始皇陵L	唐	李显	眷言 君 失德 ， 骊邑L 想 秦余 ， 政颂 方 改篆 ， 愚俗 乃 焚书 。 阿房L 火 已灭 ， 阁道 遂 成墟 。 欲厌 东南 气 ， 翻伤 掩 鲍车 。
始皇陵L	唐	罗隐	荒草 无堆 树 无枝 ， 懒向 行人 问 昔时 。 六国 英雄 漫 多事 ， 到头 徐福P 是 男儿 。
途经 秦始皇墓L	唐	许浑	龙盘 虎踞 树 层层 ， 势入 浮云 亦是 崩 。 一种 青山 秋草 里 ， 路人 唯拜 汉文陵L 。
祖龙P 引	清	朱瑄	徐福P 楼船 竟 不还 ， 祖龙P 旋已 葬 骊山L 。 琼田L 倘致 长生 草 ， 眼见 诸侯 尽 入关 。
阿房宫L	唐	胡曾	新建 阿房L 壁 未干 ， 沛公P 兵 已 入 长安L 。 帝王 若 竭 生灵 力 ， 大业 沙崩 固 不难 。
秦宫L	清	马世杰	阿房L 周阁 百重 环 ， 美女 充庭 尽日 闲 。 频望 翠华 终 杳渺 ， 亦如 天子 望 三山 。
咸阳L	唐	李商隐	咸阳L 宫阙 郁 嵯峨 ， 六国 楼台 艳 绮罗 。 自是 当时 天帝 醉 ， 不关 秦地 有 山河 。
咸阳L 怀古	唐	韦庄	城边 人倚 夕阳楼 ， 城上 云凝 万古 愁 。 山色 不知 秦苑 废 ， 水声 空傍 汉宫 流 。 李斯P 不向 仓中 悟 ， 徐福P 应无 物外 游 。 莫怪 楚吟 偏 断骨 ， 野烟 踪迹 似 东周T 。
咸阳L	唐	胡曾	一朝 阎乐 统群 凶 ， 二世P 朝廷 扫地 空 。 唯有 渭水 流 不尽 ， 至今 犹绕 望夷宫L 。
咸阳L 怀古	唐	刘兼	高秋T 咸镐L 起 霜风 ， 秦汉T 荒陵 树叶 红 。 七国 斗鸡 方 贾勇P ， 中原 逐鹿 更 争雄 。 南山 漠漠 云 常在 ， 渭水 悠悠 事 旋空 。 立马 举鞭 遥望 处 ， 阿房L 废址 夕阳 东 。
咸阳L	金	赵秉文	渭水桥L 边 不见 人 ， 摩挲 高冢 卧 麒麟 。 千秋 万古 功名 骨 ， 化作 咸阳L 原上 尘 。
咸阳L 怀古	元	施子博	咸阳L 秋水 草离离 ， 千古 愁云 锁 翠微 。 黄犬 已亡 秦鹿 失 ， 白蛇 方斩 汉龙 飞 。 烟消 古国 空 流水 ， 树老 荒城 自 落晖 。 应是 骊山L 九泉 下 ， 死魂 犹望 采紫 归 。
咸阳L 怀古	元	熊鼎	立马 平原 望 故宫 ， 关河L 百二 古今 雄 。 南山 双阙 阿房L 近 ， 北斗 连城 渭水L 通 。 龙去 野云 收 三气 ， 鹤巢 陵树 起 秋风 。 英雄 事业 昭 前哲 ， 看取 秦皇P 汉武P 功 。
咸阳L 怀古	清	严虞惇	六王 毕 后 霸图 空 ， 三百 离宫 一炬 中 。 八水 凄清 秋色 早 ， 九峻L 嶻嶭 夕阳 红 。 车回 博浪沙L 中 客 ， 舟引 蓬莱 海上 风 。 自料 骊山L 万年 计 ， 岂知 遗恨 在 樵童 。
咸阳L 怀古	明	徐震	阿房L 宫殿 对 南山L ， 阁道 萦回 霄汉 间 。 霸业 终随 烽火 尽 ， 游魂 俄载 属车 还 。 三千 童女 空 浮海 ， 十万 貔貅 已 入关 。 留得 当年 遗恨 在 ， 长城L 血泪 土 犹斑 。
秦皇庙L	明	林弼	蚕食 雄风 逐 逝波 ， 荒祠 寂寂 寄 岩阿 。 三神 山下 仙舟 远 ， 万里 城边 战骨 多 。 东鲁L 尚存 周礼乐 ， 西秦L 空壮 汉山河 。 早知 二世P 无多 祚 ， 崖石 书功 不用 磨 。
焚书坑L	唐	章碣	竹帛 烟销 帝业 虚 ， 关河 空锁 祖龙P 居 。 坑灰 未冷 山东L 乱 ， 刘项P 原来 不 读书 。
飞龙 引	唐	李白	黄帝P 铸鼎 于 荆山L ， 炼 丹砂 ， 丹砂 成 黄金 ， 骑龙 飞上 太清P 家 ， 云愁 海思 令人 嗟 。 宫中 彩女 颜 如花 ， 飘然 挥手 凌 紫霞 。 从风 纵体 登 鸾车 。 登 鸾车 ， 侍 轩辕P ， 遨游 青天 中 ， 其乐 不可 言 。
桥山L 怀古	唐	 舒元舆	轩辕P 厌代 千万 秋 ， 绿波 浩荡 东南 流 。 今来 古往 无不 死 ， 独有 天地 长悠悠 。 神仙 天下 亦 如此 ， 况 我 戚促 同 蜉蝣 。 谁言 衣冠 葬 其下 ， 不见 弓剑 何人 收 。 崆峒L 求道 失 遗迹 ， 荆山L 铸鼎 余 荒丘 。 君不见 黄龙 飞去 山下 路 ， 断髯 成草 风飕飕 。
桥山L 祈 仙台	明	张三丰	披云 履水 谒 桥陵 ， 翠柏 烟含 玉露 轻 。 袞冕 霞飞 天地 老 ， 文章 星焕 海山 青 。 巍巍 凤阙 迎 仙岛 ， 渺渺 龙车 驻 帝城 。 寂寞 琼台L 遗 汉武P ， 一轮 皓月 古今 明 。
桥山L	明	李梦阳	黄帝P 骑龙 事 杳茫 ， 桥山L 未必 葬 冠裳 。 内经 泄秘 无 天地 ， 律吕 通神 有 凤凰 。 创见 文明 归 制度 ， 要知 垂拱 变 洪荒 。 汉皇P 巡视 西游 日 ， 万有 八千 空路 长 。
读 《 汉纪 》	唐	徐寅	布衣 空手 取 中原 ， 劲卒 雄师 不足 论 。 楚国T 八千 秦T 百万 ， 豁开 胸臆 一齐 吞 。
长陵L	唐	唐彦谦	长陵L 高阙 此 安 刘 ， 附葬 累累 尽 列侯 。 丰上L 旧居 无 故里 ， 沛中P 原庙L 对 荒丘 。 耳闻 明主 提 三尺 ， 眼看 愚民 盗 一抔 。 千载 腐儒 骑 瘦马 ， 渭城L 斜月 重 回头 。
长陵L 怀古	清	张干	马上 飞龙 诧 乃公 ， 殿前 功狗 困 群雄 。 山河 有分 归 隆准P ， 今古 无人 续 《 大风 》 。 二水 带围 松柏 路 ， 诸陵 星拱 鼎湖宫 。 竖儒 漫说 闲 丘陇 ， 祀典 皇家 累世 崇 。
茂陵L	清	王昙	祖龙P 而后 事 驱除 ， 千古 雄才 断 不如 。 一统 早收 南越L 地 ， 六经 始重 圣人 书 。 求言 帝度 容 方朔P ， 问道 儒官 用 仲舒P 。 五十四年 文治 日 ， 天山 犁得 幕庭L 墟 。
雨后 望 昭陵L	清	陈维	雨后 昭陵L 景色 稀 ， 文皇P 弓剑 此中 归 。 九原L 不听 徐妃P 谏 ， 又向 山头 建 翠微 。
九月九日 上幸 慈恩寺L 登浮图 ， 群臣 上 菊花 寿酒	唐	上官婉儿	帝里 重阳节T ， 香园 万乘 来 。 却 邪萸 入佩 ， 献 寿菊 传杯 。 塔类 承天 涌 ， 门疑 待 佛 开 。 睿词 悬 日月 ， 长得 仰 昭回 。
乾陵L	清	王庆澜	坤德 乃 乘乾 ， 月魄 辄 掩日 。 其才 虽 足雄 ， 毋乃 太 突兀 。 昔称 则天后 ， 遽谓 天 可 则 。 宇宙 创 奇局 ， 今古 竟 无匹 。 来自 魔道 中 ， 帝 亦 莫之 咈 。 六珈 忽 冕旒 ， 廿年 不 巾帼 。 能用 狄梁公P ， 岂曰 非 圣哲 。 更喜 独 怜才 ， 弗怒 宾王P 檄 。
武后陵L	清	袁枚	高卷 珠帘 二十年 ， 女人 星换 紫微 天 。 明堂 黜配 无 光武P ， 本纪 开端 有 史迁 。 鹤监 尽容 才子 住 ， 南衙 不放 阿师P 颠 。 莲花 霜折 宫床 冷 ， 犹见 金轮P 荡 晚烟 。
乾陵L	宋	刘仲游	冬苑 花开 瑞气 殊 ， 唐朝T 周号T 谩窥 图 。 聪明 终悟 梁公P 谏 ， 宗庙 礼仪 无 袝姑 。
乾陵L	元	刘基	蕃王P 俨倚 立 层层 ， 天马 排行 势 欲腾 。 自是 登临 多 好景 ， 岐山L 望足 看 昭陵L 。
无 字碑 题诗	清	许孙荃	突突 孤孤 插 太清 ， 行人 遥指 是 乾陵L 。 则天P 虐焰 今 何在 ， 台殿 焚烧 石兽 崩 。 乾陵L 松柏 遭 兵燹 ， 满野 牛羊 春草 齐 。 惟有 乾人 怀 旧德 ， 年年 麦饭 祀 昭仪P 。
明皇P 秉烛 夜游 图	明	高启	花萼楼L 头 日 初堕 ， 紫衣 催上 宫门 锁 。 大家 今夕 宴 西园 ， 高热 银盘 百枝 火 。 知更 宫女 报 铜签 ， 歌舞 休催 方 夜半 。 共言 醉饮 终 此宵 ， 明日 且 免 群臣 朝 。 只愁 风露 渐 欲冷 ， 妃子 衣薄 愁 成 娇 。 琵琶 羯鼓 相 追逐 ， 白日 君心 欢 不足 。 姑苏 台上 长夜 歌 ， 江都宫L 里 飞萤 多 。 一般 行乐 未知 极 ， 烽火 忽至 将 如何 ？
行宫	唐	元稹	寥落 古 行宫 ， 宫花 寂寞 红 。 白头 宫女 在 ， 闲坐 说 玄宗P 。
长恨歌	唐	白居易	渔阳L 鼙鼓 动地 来 ， 惊破 霓裳 羽衣曲 。 九重 城阙 烟尘 生 ， 千乘 万骑 西南 行 。 翠华 摇摇 行 复止 ， 西出 都门 百余 里 。 六军 不发 无奈 何 ， 宛转 蛾眉 马前 死 。 花钿 委地 无人 收 ， 翠翘 金雀 玉 搔头 。 君王 掩面 救 不得 ， 回看 血泪 相和 流 。 蜀江L 水碧 蜀山L 青 ， 圣主 朝朝 暮暮 情 。 天旋 地转 回 龙驭 ， 到此 踌躇 不能 去 。 马嵬坡L 下 泥土 中 ， 不见 玉颜 空死 处 。 君臣 相顾 尽 沾衣 ， 对此 如何 不 泪垂 。 鸳鸯 瓦冷 霜华 重 ， 翡翠 衾寒 谁 与共 。 悠悠 生死 别 经年 ， 魂魄 不曾 来 入梦 。 忽闻 海上 有 仙山 ， 山在 虚无 飘渺 间 。 楼阁 玲珑 五云 起 ， 其中 绰约 多 仙子 。 中有 一人 字 太真P ， 雪肤 花貌 参差 是 。 含情 凝睇 谢 君王 ， 一别 音容 两 渺茫 。 昭阳殿L 里 恩爱 绝 ， 蓬莱宫L 中 日月 长 。 临别 殷勤 重 寄词 ， 词中 有誓 两心 知 。 七月七日 长生殿L ， 夜半 无人 私语 时 ： 在天 愿作 比翼鸟 ， 在地 愿为 连理枝 。 天长 地久 有时 尽 ， 此恨 绵绵 无 绝期 。
马嵬L	唐	李商隐	海外 徒闻 更 九州L ， 他生 未卜 此生 休 。 空闻 虎旅 传 宵柝 ， 无复 鸡人 报 晓筹 。 此日 六军 同 驻马 ， 当时 七夕T 笑 牵牛P 。 如何 四纪 为 天子 ， 不及 卢家 有 莫愁 。
马嵬佛寺L	唐	温庭筠	荒鸡 夜唱 战 尘深 ， 五鼓 雕舆 过 上林L 。 才信 倾城 是 真语 ， 直教 涂地 始 甘心 。 两重 秦苑 成 千里 ， 一炷 胡香 抵 万金 。 曼倩P 死来 无 绝艺 ， 后人 谁肯 惜 青禽 。
马嵬坡L	唐	张祜	旌旗 不整 奈君 何 ， 南去 人稀 北去 多 。 尘土 已残 香 粉艳 ， 荔枝 犹到 马嵬坡L 。
马嵬坡L	唐	郑畋	玄宗P 回马 杨妃P 死 ， 云雨 难忘 日月 新 。 终是 圣明 天子 事 ， 景阳L 宫井 又 何人 。
帝 幸 蜀	唐	罗隐	马嵬L 烟柳 正 依依 ， 又见 銮舆 幸 蜀 归 。 泉下 阿蛮P 应有 语 ： 这回 休 更 怨 杨妃P 。
马嵬L	唐	黄滔	锦江L 晴碧 剑峰L 奇 ， 合有 千年 降圣 时 。 天意 从来 知 幸 蜀L ， 不关 胎祸 自 蛾眉 。
马嵬L	唐	徐夤	二百年 来 事 远闻 ， 从龙 谁 解 尽 如云 。 张均P 兄弟 皆 何在 ， 知是 杨妃P 死 报君 。
杨妃P	宋	真山民	三郎P 掩面 马嵬坡L ， 生死 恩深 可 奈何 。 瘗土 驿傍 何足 恨 ， 潼关L 战处 骨埋 多 。
马嵬L	金	高有邻	事去 君王 不 奈何 ， 荒坟 三尺 马嵬坡L 。 归来 枉为 香囊 泣 ， 不道 生灵 泪 更多 。
杨妃墓L	元	马祖常	汉庙 衣冠 照 碧磷 ， 唐陵 翁仲 作 黄尘 。 马嵬坡L 上 棠梨树 ， 犹占 秦原 几日 春 。
马嵬L 怀古	清	王士禛	巴山L 夜雨 欲 归秦 ， 金粟 堆边 草 不春 。 一种 倾城 好 颜色 ， 茂陵 终傍 李夫人P 。
马嵬L 之一	清	袁枚	倚杖 营门 泪 数行 ， 君臣 此际 太 仓皇 。 兴元T 一诏 三军 泣 ， 何必 伤心 向 佛堂 。
马嵬L 之二	清	袁枚	莫唱 当年 长恨歌 ， 人间 亦 自 有 银河 。 石壕村L 里 夫妻 别 ， 泪 比 长生殿L 上 多 。
再题 马嵬驿L	清	袁枚	到底 君王 负 前盟 ， 江山 情重 美人 轻 。 玉环 领略 夫妻 味 ， 从此 人间 不 再生 。 不须 铃曲 怨 秋声 ， 何必 仙山 海上 行 。 只要 姚崇P 还 作相 ， 君王 妃子 共 长生 。
马嵬坡L	清	赵翼	宠极 强藩P 已 不臣 ， 枉教 红粉 委 荒尘 。 怜香 不尽 千 词客 ， 召乱 何关 一 美人 。 堠火 自明 孤驿 夜 ， 野火 犹泣 故宫 春 。 谁知 几点 胭脂 泪 ， 别有 生离 江采苹P 。
古来 咏 杨妃P 者 多矣 ， 多失 其平 ， 戏为 一绝	清	赵翼	鼙鼓 渔阳L 为 翠娥 ， 美人 若在 肯 休戈 ？ 马嵬L 一死 追兵 缓 ， 妾为 君王 拒贼 多 。
马嵬L 怀古	清	毕沅	龙武P 空传 仗钺 威 ， 延秋门L 启 夜乌 飞 。 若教 郭李P 从 西幸 ， 肯舍 强藩P 杀 贵妃P 。
马嵬L	清	赵长龄	不信 曲江P 信 禄山P ， 渔阳L 鼙鼓 震 秦关L 。 祸端 自是 君王 启 ， 倾国 何须 怨 玉环P 。
杨妃P	清	郭秉慧	绝代名花 一笑 倾 ， 马嵬坡L 下 总 无情 。 凄凉 罗袜 千秋 恨 ， 悔煞 长生殿L 里 盟 。
题 楼观L	唐	岑参	草楼L 荒井 闭 空山 ， 关令P 乘云 去 不还 。 羽盖 霓旌 何处 在 ， 空留 药臼 向 人间 。
楼观L	宋	苏轼	门前 古碣 卧 斜阳 ， 阅世 如流 事 可伤 。 长有 幽人 悲 晋惠P ， 强修 遗庙 学 秦皇P 。 丹砂 久窖 井水 赤 ， 白朮 谁烧 厨灶 香 ？ 闻道 神仙 亦 相过 ， 只疑 田叟 是 庚桑P 。
登 太白峰L	唐	李白	西上 太白峰L ， 夕阳 穷 登攀 。 太白 与我 语 ， 为我 开 天关 。 愿 乘 泠风 去 ， 直出 浮云 间 。 举手 可 近月 ， 前行 若 无山 。 一别 武功 去 ， 何时 复见 还 。
望 太白山L	清	张问陶	形势 抗 西岳L ， 尊严 朝 百灵 。 雪留 秦汉T 白 ， 山界 雍梁L 青 。 鸟道 欺 三峡L ， 神功 怯 五丁 。 峨眉L 可 横绝 ， 归梦 记 曾经 。
鸿门L 宴	唐	王毂	寰海 沸 兮 争战 苦 ， 风云 愁 兮 会 龙虎 。 四百年 汉 欲 开基 ， 项庄P 一剑 何 虚舞 。 殊不知 人心 去 暴秦 ， 天意 归 明主 。 项王P 足底 踏 汉土 ， 席上 相看 浑 未悟 。
赋得 亚父P 碎 玉斗	唐	孟简	献谋 既 我 违 ， 积愤 从 心痗 。 鸿门L 入 已迫 ， 赤帝P 时 潜退 。 宝位 方 苦竞 ， 玉斗 何 情爱 。 犹看 虹气 凝 ， 讵惜 冰姿 碎 。 而嗟 大事 返 ， 当起 千里 悔 。 谁为 西楚王P ， 坐见 东城L 溃 。
鸿门L 宴	宋	刘翰	江东L 遥遥 八千 骑 ， 大战 小战 七十二 。 子婴P 已降 隆准公P ， 君王 置酒 鸿门L 东 。 张良P 已去 玉斗 碎 ， 三月T 火照 咸阳L 红 。 当时 已失 范增P 谋 ， 尚引 长戈 到 垓下L 。 明朝 宝马 一声 嘶 ， 江北L 江东L 皆 汉土 。
鸿门L	唐	胡曾	项籍P 鹰扬 六合 尘 ， 鸿门L 开宴 贺 亡秦 。 樽前 若取 谋臣 计 ， 岂作 阴陵 失道 人 。
过 五丈原L	唐	温庭筠	铁马 云雕 久 绝尘 ， 柳阴 高压 汉营 春 。 天晴 杀气 屯 关右L ， 夜半 妖星 照 渭滨 。 下国L 卧龙P 空 误主 ， 中原 逐鹿 不 因人 。 象床 锦帐 无 言语 ， 从此 谯周P 是 老臣 。
怀贤阁L	宋	苏轼	南望 斜谷L 口 ， 三山 如 犬牙 。 西观 五丈原L ， 郁屈 如 长蛇 。 有怀 诸葛公P ， 万骑 出 汉巴L 。 公才 与 曹丕P ， 岂止 十倍 加 。 往事 逐云 散 ， 故山 依 渭斜L 。 客来 空 吊古 ， 清泪 落 悲笳 。
五丈原L 怀古	宋	蒋子奇	蜀相 扬声 欲 取 郿L ， 关中 形势 已 全窥 。 当时 不是 长星 坠 ， 席卷 中原 未 可知 。
五丈L 秋风	明	王祎	一片 西原L 土 ， 空埋 尽瘁 身 。 凄凄 烟树 冷 ， 似泣 汉家T 春 。
落星湾L	明	高启	莫恨 长星 堕 渭滨L ， 出师 未捷 已 沾巾 。 天应 留得 生司马P ， 归作 当年 取魏 人 。
武侯庙L	明	杨慎	剑江L 春水 绿沄沄 ， 五丈原L 头 日 又 曛 。 旧业 未能 归 后主P ， 大星 先已 落 前军 。 南阳L 祠宇 空 秋草 ， 西蜀L 关山 隔 暮云 。 正统 不惭 传 万古 ， 莫将 成败 论 三分 。
五丈原L 怀古	清	万方煦	赤帝子孙P 燃 爝火 ， 南阳L 蟠龙P 不得 卧 。 天定 三分 汉鼎 破 ， 秋风 惨黯 大星 堕 。 前 出师 ， 后 出师 ， 成败 利钝 未可 知 。 臣 身死 ， 心 不死 ， 灭魏 吞吴 事 竟 止 。 五丈原L 头 落日 高 ， 白帝城L 边 怒风 号 。 丹旐 西归 泣 杜宇 ， 萧萧 故垒 卧 蓬蒿 。
五丈原L 怀古	请	方六琴	英风 尚想 建兴年T ， 汉祚T 存亡 重 仔肩 。 二表 切陈 唯 报主 ， 三分 已定 欲 回天 。 雌雄 决策 羞 曹魏L ， 生死 怜才 只 晋宣P 。 千载 斜川 呜咽 水 ， 春耕 犹是 旧 屯田 。
武侯墓L	明	薛瑄	丞相 孤坟 何处 寻 ？ 褒斜L 西出 汉江L 阴 。 青芜 漠漠 烟 横野 ， 翠柏 森森 风 满林 。 尚忆 出师 当日 表 ， 空歌 《 梁甫 》 旧时 吟 。 中原 未复 星 先陨 ， 长使 英雄 慨 古今 。
沔县L 谒 诸葛忠 武侯祠L	清	王土禛	天汉 遥遥 指 剑关L ， 逢人 先问 定军山L 。 惠陵L 草木 冰霜 里 ， 丞相 祠堂 桧柏 间 。 八阵 风云 通 指顾 ， 一江 波浪 急 潺湲 。 遗民 衢路 还 私祭 ， 不独 英雄 血泪 斑 。
武侯庙L	清	张潮	丞相 遗迹 不可 寻 ， 汉南L 沔水L 气 萧森 。 云霞 树绕 旌旗 色 ， 风雨 江传 鼓吹 音 。 据鼎 三分 非 本计 ， 出师 二表 见 初心 。 独怜 星陨 荒 祠庙 ， 千古 忠怀 激 素襟 。
沔县L 诸葛武侯祠L	清	允礼	遭逢 鱼水 自 南阳L ， 将相 才兼 管乐P 长 。 羽扇 风流 看 节制 ， 草庐 云卧 俗 筹量 。 丹心 一片 安 炎鼎L ， 浩气 千秋 壮 蜀疆 。 庙貌 嵯峨 沔水L 侧 ， 入门 瞻拜 肃 冠裳 。
武侯祠L	清	任兰枝	丞相 祠堂 沔阳L 浒 ， 松柏 森森 铁 干古 。 行人 指点 定军山L ， 月黑 天阴 闻 战鼓 。 我来 下马 拜 荒丘 ， 三代 而还 第一 流 。 绵竹L 战余 瞻尚 死 ， 一门 忠烈 壮 千秋 。
留侯祠L	清	钱载	祠屋 近 柴关L ， 高峰 西面 环 。 犹传 赤松子 ， 相望 定军山L 。 事业 兴衰 际 ， 英雄 气数 间 。 洞门 七十二 ， 惟有 泄云 还 。
谒 留侯祠L	清	胡超	山势 嵯峨 翠柏 芳 ， 留侯L 辟谷 越 寻常 。 忠心 一点 复 韩国L ， 义气 千秋 报 汉王 。 妙算 秘承 黄石册 ， 高风 独托 赤松 藏 。 我来 瞻仰 钦 遗范 ， 借箸 安刘 仰 子房P 。
汉台L 怀古	清	岳礼	俯首 逢 漂母 ， 扬眉 见 汉王P 。 如何 成 帝业 ， 不肯 念 云乡 。 钟室 怨 芳草 ， 将台 犹 夕阳 。 临江 春 欲暮 ， 古色 日 苍苍 。
汉台L	清	陈毓彩	赤帝P 龙兴 事 已陈 ， 层台 巩固 尚 如新 。 当日 宫廷 湮没 迹 ， 此时 郡国 有 仁人 。
汉台L	清	王士祯	凤云 今 寂寞 ， 江汉L 自 波澜 。
拜将坛L	明	何景明	汉主P 西 封日 ， 淮阴P 拜将 时 。 坛场 如 往日 ， 朝代 几 迁移 。 王气 风云 歇 ， 雄图 日月 垂 。 江山 吊 故国 ， 谁复 见 旌旗 。
拜将台L	明	侯居坤	汉水 城南 万木 丛 ， 高皇 曾此 拜 元戎 。 兴 刘 赤帜 多多善 ， 拒彻 丹心 耿耿忠 。 项蹶P 乌江L 功 已最 ， 身擒 云梦 计 何穷 。 登坛 旧迹 今 犹在 ， 千古 人怀 国士 风 。
拜将坛L	清	李柏	无情 风雨 入 荒台 ， 黯淡 愁云 锁 不开 。 一统 山河 平 上将 ， 万邦 奠定 忌 雄才 。 天怜 国士 存 韩半 ， 地显 丹心 赤 草莱 。 莫怪 子房P 耽 避谷 ， 良弓 高鸟 正 堪猜 。
拜将台L 怀古	清	张炳蔚	江流 咽尽 鼓鼙 声 ， 谁似 淮阴P 善 将兵 ？ 学剑 早轻 万人 敌 ， 登坛 还使 一军 惊 。 从龙 几见 侯封 遂 ， 鷕雉 翻教 祸水 成 。 猛土 飘零 王气 歇 ， 歌风 台下 暮云 横 。
将台L 怀古	清	章炬	高秋 乘兴 一 登台 ， 云净 天空 四望 开 。 远浦 烟光 迷 岭岫 ， 平芜 野色 上 蒿莱 。 重瞳 慢敌 谁知 勇 ？ 隆准P 轻儒 实 爱材 。 推毂 筑坛 千载 事 ， 英雄 过此 尽 徘徊 。
题 司马迁墓L	北宋	李奎	著书 虽已 先 三史 ， 论道 如何 后 六经 。 因雪 李陵P 为 国士 ， 岂期 武帝P 有 宫刑 。 丛生 荆棘 迷 坟冢 ， 旧画 龙蛇 照 庙庭 。 为贤 遗文 来 一奠 ， 不知 何在 子长P 灵 。
题 汉太史 司马迁墓L	金	完颜璟	汉庭 文物 萃君 门 ， 良史 独称 司马 尊 。 七十卷书 终始 备 ， 三千年事 是非 存 。 李陵P 设若 无 先见 ， 王允P 何由 有 后言 。 古庙 风霜 香火 冷 ， 自云 衰草 满 平原 。
过 太史 司马迁墓L	明	伍福	天马行空 间世 才 ， 壮游 踪迹 久 尘埃 。 云霞 五色 凝 生气 ， 松柏 千秋 锁 墓台 。 故里 龙门L 犹 在望 ， 余年 蚕室 重 堪哀 。 我来 谒拜 微诚 滴 ， 薄采 溪毛 奠 一杯 。
谒 太史公墓L	明	叶梦熊	大河L 东去 世 茫然 ， 司马P 残碑 记 汉年T 。 狐史P 是非 犹 白日 ， 龙门L 踪迹 亦 浮烟 。 玉书 神护 空 遗穴 ， 石室 云藏 有 剩篇 。 国士 漂零 同 感慨 ， 一杯 和泪 滴 重泉 。
太史公墓L	清	赵于京	汉代T 文章 贵 ， 龙门L 气象 雄 。 天才 均 独洁 ， 史学 世 能工 。 丘垄 黄河L 护 ， 英灵 华岳L 空 。 救陵 千载 事 ， 慷慨 有 余风 。
太史公 司马子长墓L	清	康乃心	夏阳L 三 晋地 ， 东去 向 黄河L 。 大壑L 开 平野 ， 高愿 莽 薜萝 。 一丘 司马墓L ， 终古 少梁L 阿 。 几度 寒榛 里 ， 客来 感慨 多 。
题 潼关楼L	唐	崔颢	客行 逢 雨霁 ， 歇马 上 津楼L 。 山势 雄 三辅L ， 关门 扼 九州L 。 川 从 陕路L 去 ， 河绕 华阴L 流 。 向晚 登临 处 ， 风烟 万里 愁 。
潼关L 吏	唐	杜甫	士卒 何 草草 ， 筑城 潼关道L 。 大城 铁 不如 ， 小城 万丈 余 。 借问 潼关L 吏 ， 修城 还 备胡 。 丈人 视 要处 ， 窄狭 容 单车 。 艰难 奋 长戟 ， 万古 用 一夫 。 请嘱 防 关将 ， 慎勿 学 哥舒P 。
望 海潮 从 军舟 中 作	金	折元礼	地雄 河岳 ， 疆分 韩晋L ， 潼关L 高压 秦头 。 山倚 断霞 ， 江吞 绝壁 ， 野烟 萦带 沧洲L 。 虎旆 拥 貔貅 。 看 阵云 截岸 ， 霜气 横秋 。 千雉 严城 ， 五更 残角 月 如 钩 。 西风 晓入 貂裘 。 恨 儒冠 误我 ， 却 羡 兜鍪 。 六郡 少年 ， 三明P 老将 ， 贺兰L 烽火 新收 。 天外 岳连楼L 。 想 断云 横晓 ， 谁识 归舟 。 剩着 黄金 换酒 ， 羯鼓 醉 凉州L 。
题 潼关L	明	李梦阳	咸东L 天险 设 重关 。 闪日 旌旗 虎豹 闲 。 隘地 黄河L 吞 渭水L ， 炎天 白雪 压 秦山L 。 旧京L 想象 千官 入 ， 余恨 逡巡 六国 还 。 满眼 非无 弃繻 者 ， 寄言 军吏 莫 嗔颜 。
入 潼关L	明	王九思	客子 来 何暮 ， 关门 愧 昔贤 。 首阳祠L 未远 ， 商洛路L 依然 。 飞鸟 三峰 外 ， 孤城 落照 前 。 终军P 今 白首 ， 非复 弃繻 年 。
潼关L	清	王士禛	潼津L 直上 势 嵯峨 ， 天险 初从 百二 过 。 两界 中分 蟠太华L ， 孤城 北折 走 黄河L 。 复隍 几见 熊罴 守 ， 弃甲 空传 犀兕 多 。 汉阙 唐陵 尽 千黍 ， 雁门司马P 恨 如何 。
望 潼关L	清	峻德	立马 风陵L 望 汉关L ， 三峰 高出 白云 间 。 西来 一曲 昆仑L 水 ， 划断 中条 太华山L 。
潼关L	清	洪亮吉	出险 复 入险 ， 别山 仍 上山 。 河流 五夜 色 昏黑 ， 一片 日红 先 射关 。 壮哉 龙门L 涛 ， 至此 始 一折 。 君不见 哥舒P 拒 禄山P ， 魏武P 破 孟起P 。 门开 如云 列 千骑 ， 喧声 动天 箭 洒地 。 时平 云气 亦 卷舒 ， 孱卒 立门 司 启闭 。 关头 饭罢 客 亦 闲 ， 早有 太华L 开心 颜 。
中吕 山坡羊 · 潼关L 怀古	元	张养浩	峰峦 如聚 ， 波涛 如怒 ， 山河 表里 潼关路L 。 望 西都L ， 意 踟蹰 。 伤心 秦汉T 经 行处 ， 宫阙 万间 都 做了土 。 兴 ， 百姓 苦 ； 亡 ， 百姓 苦 。
金城L 北楼	唐	高适	北楼 西望 满 晴空 ， 积水 连山 胜画 中 。 湍上 急流 声 若箭 ， 城头 残月 势 如弓 。 垂竿 已羡 磻溪L 老 ， 体道 犹思 塞上 翁 。 为问 边庭 更 何事 ， 至今 羌笛 怨 无穷 。
题 金城L 临河驿楼L 	唐	岑参	古戍 依 重险 ， 高楼 接 五凉L 。 山根 盘 驿道 ， 河水 浸 城墙 。 庭树 巢 鹦鹉 ， 园花 隐 麝香 。 忽如 江浦 上 ， 忆 昨 捕鱼 郎 。
望 海潮	金	邓千江	云雷 天堑 ， 金汤L 地险 ， 名藩 自古 皋兰L 。 营屯 绣错 ， 山形 米聚 ， 喉襟 百二 秦关L 。 鏖战 血 犹 殷 。 见 阵云 冷落 ， 时有 雕盘 。 静塞 楼头 ， 晓月 依旧 玉弓 弯 。 看看 。 定远P 西还 。 有 元戎 阃令 ， 上将 斋坛 。 区脱 昼空 ， 兜铃 夕解 ， 甘泉L 又 报 平安 。 吹笛 虎牙 閒 。 且宴 珠履 ， 歌按 云鬟 。 招取 英灵 毅魄 ， 长绕 贺阑山L 。
闲游 黄河L 岸	清	张澍	一片 孤城 枕 石关 ， 河流 飞入 断 云间 。 滔滔 东去 谁能 挽 ， 赖有 龙门L 底柱山L 。
白塔寺L	明	李文	金城L 关外 寺 ， 殿宇 枕 岩阿 。 地辟 飞沙 少 ， 山高 怪石 多 。 钟声 闻 紫塞L ， 塔影 浸 黄河L 。 最爱 谈 禅处 ， 何妨 载酒 过 。
游 五泉L	明	李文	四面 峰峦 紫翠 连 ， 白云 深处 有 人烟 。 落花 泛泛 流 双涧 ， 古塔 巍巍 出 半天 。 福地 近城 三四里 ， 名师 卓锡 几千年 。 上人 邀我 烹 新茗 ， 水汲山L 中 第 五泉L 。
秋日 泛 舟泉湖L 作	清	左宗棠	昔岁 来 兰州L ， 随槎 想 碧落 。 黄河L 横 节园L ， 牛女 看 约略 。 以 槎 名 其亭 ， 南对 澄清阁L 。 走笔 题 一系 ， 乡心 慰 寂寞 。
别 兰州L	清	谭嗣同	前度 别 皋兰L ， 驱车 今 又还 。 两行 出塞 柳 ， 一带 赴 城山 。 壮士 事 戎马 ， 侯封 入 汉关L 。 十年 独 何似 ， 转徙 愧兵 间 。
嘉峪L 晴烟	明	戴弁	烟笼 嘉峪L 碧 岧峣 ， 影拂 昆仑L 万里 遥 。 暖气 常浮 春 不老 ， 寒光 欲散 雪 初消 。 雨收 远岫 和 云湿 ， 风度 疏林 带雾 飘 。 最是 晚来 闲望 处 ， 夕阳 山外 锁 山腰 。
嘉峪关L 感赋	清	林则徐	严关 百尺 界 天西 ， 万里 征人 驻 马蹄 。 飞阁 遥连 秦树 直 ， 潦垣 斜压 陇云 低 。 天山 巉削 摩肩 立 ， 瀚海 苍茫 入望 迷 。 谁道 殽函L 千古 险 ， 回看 只见 一丸 泥 。
出 嘉峪关L	清	裴景福	太华L 终南L 翠 作屏 ， 黄沙 黑水 万重 经 。 春风 杨柳 三千里 ， 一出 长城L 不肯 青 。
游 千佛洞L	清	汪隆	古郡 敦煌L 远 ， 幽崖 佛洞 传 。 建垣 新 日月 ， 访胜 旧 山川 。 窦启 琳宫 现 ， 沙凝 法象 填 。 神工 劳 劈划 ， 匠手 巧 雕镌 。 排列 云 迢递 ， 嵌空 境 接连 。 金身 腾 百丈 ， 碧影 肃 诸天 。 色相 嗟 多毁 ， 丹青 讶 尚鲜 。
月牙泉L	清	朱凤翔	德水L 源传 星宿海L ， 灵池 胜纪 月牙泉L 。 不形 卮泄 疑 无地 ， 倘有 槎寻 定 到天 。 沙岭L 回风 森 壁立 ， 铁鱼 跋浪 蹴 涡漩 。 凭谁 问取 龙媒 迹 ， 汉武P 当年 正 拓边 。
送 翰林典籍 张敏P 行之 官西上	明	孙贲	敦煌L 城下 沙 如雪 ， 敦煌L 城头 无 六月T 。 关西L 劲卒 筑防 秋 ， 捷书 夜半 飞 龙楼 。 敦煌L 迢迢 五千里 ， 十月T 即渡 黄河L 水 。 上将 翩翩 才 且 雄 ， 平戎 不数 贰师P 功 。 太平 今见 远 宣威 ， 君往 从戎 几日 归 。 幕下 文儒 能 耀武 ， 词林 从此 有 光辉 。
凉州L 乐歌 二首 其一	南北朝	温子升	远游 武威L 郡 ， 遥望 姑臧L 城 。 车马 相 交错 ， 歌吹 日 纵横 。
凉州L 乐歌 二首 其二	南北朝	温子升	路出 玉门关L ， 城接 龙城L 坂 。 但事 弦歌 乐 ， 谁道 山川 远 。
凉州L 馆中 与 诸判官 夜集	唐	岑参	弯弯 月出 挂 城头 ， 城头 月出 照 凉州L 。 凉州L 七城 十万家 ， 胡人 半解 弹 琵琶 。 琵琶 一曲 肠 堪断 ， 风萧萧 兮 夜 漫漫 。
边思	唐	李益	腰悬 锦带 佩 吴钩 ， 走马 曾防 玉塞 秋 。 莫笑 关西L 将家 子 ， 只将 诗思 入 凉州L 。
凉州L 词	唐	薛逢	昨夜 蕃兵 报 国仇 ， 沙州L 都护 破 凉州L 。 黄河九曲L 今 归汉 ， 塞外 纵横 战血 流 。
凉州L 行	唐	王建	凉州L 四边 沙皓皓 ， 汉家 无人 开 旧道 。 边头 州县 尽 胡兵 ， 将军 别筑 防秋 城 。 万里 人家 皆 已没 ， 年年 旌节 发 西京L 。 多来 中国 收 妇女 ， 一半 生男 为 汉语 。 蕃人 旧日 不 耕犁 ， 相学 如今 种 禾黍 。 驱羊 亦 著 锦 为 衣 ， 为惜 毡裘 防斗 时 。 养蚕 缫茧 成 匹帛 ， 那堪 绕帐 作 旌旗 。 城头 山鸡 鸣 角角 ， 洛阳L 家家 学 胡乐 。
凉州L 行	元	戴良	凉州L 城头 闻 打鼓 ， 凉州L 城北 尽 胡虏 。 羽书 昨夜 到 西京L ， 胡兵 已犯 凉州城L 。 凉州L 兵气 若 云黑 ， 百万 人家 皆 已没 。 汉军 西出 笛声 哀 ， 胡骑 闻之 去 复来 。 年年 此地 成 边土 ， 竟与 胡人 相间 处 。 胡人 有妇 能 汉音 ， 汉女 亦 解 调 胡琴 。 调 胡琴 ， 按 胡谱 。 夫婿 从军 半生 死 ， 美人 踏筵 尚 歌舞 。 君不见 古来 边头 多 战伤 ， 生男 岂如 生女 强 。
咏塔寺L	明	丁昂	千尺 浮图 插 上苍 ， 禅宫 七宝 烛 灵光 。 近接 彩云 飞 太华L ， 遥随 红日 映 扶桑 。
武威L 绝句	清	许荪荃	武威L 莫道 是 边城 ， 文物 前贤 起 后生 。 不见 古来 盛名 下 ， 先于 李益P 有 阴铿 。
凉州L 词	明	张恒	垆头 酒熟 葡萄 香 ， 马足 春深 苜蓿 长 。 醉听 古来 横吹 曲 ， 雄心 一片 在 西凉L 。
陇西L 行	唐	王维	十里 一 走马 ， 五里 一 扬鞭 。 都护 军书 至 ， 匈奴 围 酒泉L 。 关山 正 飞雪 ， 烽火 断 无烟 。
肃州L 八景 八首之一 南山L 积雪	明	戴弁	酒泉L 城外 碧 云端 ， 万叠 芙蓉 雪 未干 。 素影 欲迷 银汉 回 ， 时光 不逐 暖风 残 。 气吞 沙漠 千山 远 ， 势压 番戎 六月T 寒 。 宫馆 日长 清 似水 ， 几回 吟望 倚 栏杆 。
凉州L 词	唐	王之涣	黄河L 远上 白云 间 ， 一片 孤城 万仞 山 。 羌笛 何须 怨 杨柳 ， 春风 不度 玉门关L 。
从军行	唐	王昌龄	青海L 长云 暗 雪山 ， 孤城 遥望 玉门关L 。 黄沙 百战 穿 金甲 ， 不破 楼兰L 终 不还 。
玉关L 寄 长安L 李主簿P	唐	岑参	东去 长安L 万里 馀 ， 故人 何惜 一行 书 。 玉关L 西望 堪 肠断 ， 况复 明朝 是 岁除 。
子夜 吴歌	唐	李白	长安L 一片 月 ， 万户 捣衣 声 。 秋风 吹 不尽 ， 总是 玉关L 情 。 何日 平 胡虏 ， 良人 罢 远征 。
塞上曲 二首 其二	唐	戴叔伦	汉家T 旌帜 满 阴山L ， 不遣 胡儿 匹马 还 。 愿得 此身 长 报国 ， 何须 生入 玉门关L 。
甘凉L 道中 书事 感怀	明	杨一清	望望 日 以 远 ， 行行 春 又 阑 。 苍茫 青海L 月 ， 咫尺 玉门关L 。 北阙 星辰 上 ， 南州L 梦寐 间 。 青山 随处 有 ， 一见 一 开颜 。
玉关L	明	陈棐	遥遥 金河L 水 ， 嵬嵬 玉门L 高 。 万里 天方L 道 ， 五年 土鲁L 曹 。 禹贡 球 琅玕 ， 今来 琐 葡萄 。 四夷 称 咸宾 ， 干矛 可 戢韬 。
送 元二使 安西	唐	王维	渭城L 朝雨 浥 轻尘 ， 客舍 青青 柳色 新 。 劝君 更尽 一杯 酒 ， 西出 阳关L 无 故人 。
酒泉子	宋	孙光宪	空碛 无边 ， 万里 阳关L 道路 。 马 萧萧 ， 人 去去 ， 陇L 云愁 。
阳关阁L	金	李俊民	一杯 送别 古阳关L ， 关外 千重 万叠 山 。 试问 青青 渭城L 柳 ， 不知 眼见 几人 还 。
甘州L 即事	明	郭登	黑河L 如带 向西 来 ， 河上 边城L 自 汉T 开 。 山近 四时 常见 雪 ， 地寒 终岁 不闻 雷 。 牦牛 互市 番氓 出 ， 宛马 临关 汉使 回 。 东望 玉京L 将 万里 ， 云霄 何处 是 蓬莱L 。
送 岳季方P 还京	明	郭登	登 高楼 ， 望 明月 ， 明月 秋来 几 圆缺 ？ 多情 只照 绮罗 筵 ， 莫照 天涯 远行 客 。 天涯 行客 离家 久 ， 见月 思乡 搔 白首 。 年年 尝是 送行 人 ， 折尽 边城 路傍 柳 。 东望 秦川L 一雁 飞 ， 可怜 同住 不 同归 。 身留 塞北L 空 弹铗 ， 梦绕 江南L 未 拂衣 。 君归 复喜 登台阁L ， 风裁 棱棱 尚 如昨 。 但令 四海 歌 升平 ， 我在 甘州L 贫 亦 乐 。 甘州L 城西 黑水L 流 ， 甘州L 城北 胡云 愁 。 玉关L 人老 貂裘 敝 ， 苦忆 平生 马少 游 。
山行 入 泾州L	唐	王昌龄	倦 此 山路 长 ， 停骖 问 宾御 。 林峦 信 回惑 ， 白日 落 何处 。 徙倚 望 长风 ， 滔滔 引 归虑 。 微雨 随云 收 ， 濛濛 傍山 去 。 西临 有 边邑 ， 北走 尽 亭戍 。 泾水L 横 白烟 ， 州城 隐 寒树 。 所嗟 异风 俗 ， 已自 少 情趣 。 岂伊 怀土 多 ， 触目 忻 所遇 。
安定L 城楼	唐	李商隐	迢遰 高城 百尺 楼 ， 绿杨 枝外 尽 汀洲L 。 贾生P 年少 虚 垂泪 ， 王粲P 春来 更 远游 。 永忆 江湖 归 白发 ， 欲回 天地 入 扁舟 。 不知 腐鼠 成 滋味 ， 猜意 鸳雏 竟 未休 。
陇西L 行 其七	唐	王勃	烽火 照 临洮L ， 榆塞 马 萧萧 。 先锋 秦 子弟 ， 大将 霍嫖姚P 。
陇西L 行 其八	唐	王勃	开壁 左贤 败 ， 夹战 楼兰L 溃 。 献捷 上 明光L ， 扬鞭 歌 《 入塞 》 。
自 萧关L 望 临洮L	唐	朱庆馀	玉关L 西路 出 临洮L ， 风卷 边沙 入 马毛 。 寺寺 院中 无 竹树 ， 家家 壁上 有 弓刀 。 惟怜 战士 垂 金甲 ， 不尚 游人 著 白袍 。 日暮 独吟 秋色 里 ， 平原 一望 戍楼 高 。
我 忆 临洮L 好	清	吴镇	我 忆 临洮L 好 ， 春光 满 十分 。 牡丹 开 径尺 ， 鹦鹉 过 成群 。 涣涣 西川L 水 ， 悠悠 北岭L 云 。 剧怜 三月 后 ， 赛社 日 纷纷 。
灵武台L	明	李梦阳	环县 城边 灵武台L ， 肃宗P 曾此 辟 蒿莱 。 二仪 高下 皇舆 建 ， 三极 西南 玉玺 来 。 衣白 山人 经 国计 ， 朔方 孤将 出 群才 。 可怜 一代 风云 际 ， 不劝 君王 驾鹤 回 。
寓 河州L 其一	明	解缙	只道 河州L 天 尽头 ， 谁知 更有 许多 州 。 八千 里外 泥巴国L ， 行客 经年 未 得休 。
寓 河州L 其二	明	解缙	长城L 只自 临洮L 起 ， 此去 临洮L 又 数程 。 秦地 山河 无 积石 ， 至今 花树 似 咸京L 。
登 镇边楼L	明	解缙	陇树 晴云 万里秋 ， 思亲 独上 镇边楼L 。 几年 不见 南来雁 ， 真个 河州L 天 尽头 。
秦州L 杂诗 二十首 其二	唐	杜甫	秦州L 山北寺L ， 胜迹 隗嚣宫L 。 苔藓 山门 古 ， 丹青 野殿 空 。 月明 垂 叶露 ， 云逐 渡 溪风 。 清渭L 无情 极 ， 愁时 独 向东 。
秦州L 杂诗 二十首 其七	唐	杜甫	莽莽 万重山 ， 孤城 山谷 间 。 无风 云 出塞 ， 不夜 月 临关 。 属国L 归 何晚 ， 楼兰L 斩 未还 。 烟尘 独 长望 ， 衰飒 正 摧颜 。
秦州L 杂诗 二十首 其十四	唐	杜甫	万古 仇池L 穴 ， 潜通 小有 天 。 神鱼 人 不见 ， 福地L 语 真传 。 近接 西南境 ， 长怀 十九泉L 。 何时 一 茅屋 ， 送老 白云 边 。
乾元 中 寓居 同谷县L 作歌 七首 其一	唐	杜甫	有客 有客 字 子美P ， 白头 乱发 垂过 耳 。 岁拾 橡栗 随 狙公 ， 天寒 日暮 山谷 里 。 中原 无书 归不得 ， 手脚 冻皴 皮肉 死 。 呜呼 一歌 兮 歌 已哀 ， 悲风 为我 从天 来 。
麦积山L	宋	李师中	路入 青松 翠蔼 间 ， 夕阳 倒影 下 溪湾 。 此中 猿鹤 休 相笑 ， 谢傅P 东归 自有 山 。
与 麦积山L 上人	明	胡缵宗	南有 香积寺L ， 北有 麦积山L 。 山人 拾 瑶草 ， 白云 相与 还 。
麦积山L	清	王宽	麦积L 通 天栈 ， 悬崖 势 仙垂 。 路盘 七佛洞L ， 龛蚀 六朝碑L 。 拓掌 仙人 立 ， 登门 石笋 奇 。 寻幽 探 虎窟 ， 为访 杜陵P 诗 。
冰灵寺L	明	解缙	冰灵寺L 上 山 如削 ， 柏树 龙蟠 点 翠微 。 况有 冰桥 最 奇绝 ， 银虹 一道 似 天梯 。
游 灵岩寺L 记	明	王荷泽	尝拟 谢灵运P ， 惜为 气力 殊 。 降心 随 小路 ， 骇浪 虑 轻桴 。 过眼 峰 堪 画 ， 插天 阁 欲扶 。 淟然 闻 土谷 ， 罗拜 礼 金瞿 。
崆峒山L	宋	游师雄	崆峒L 一何 高 ， 崛起 乾坤 辟 。 峻极 倚 杳冥 ， 峥嵘 亘 今昔 。
怀古	明	王贤	汉帝P 西来 驾 六龙 ， 遥临 祖厉L 驻 游踪 。 未央L 石篆 成 蹊径 ， 长乐宫L 中 想 壮容 。 威振 四夷 光 禹甸 ， 边开 诸郡 拓 尧P 封 。 大明 一统 收 沙漠 ， 鼎定 乾坤 孰若 浓 ？
崆峒L	明	陈讲	欲访 飞仙阁L ， 先临 问道宫L 。 乱云 交 密竹 ， 斜日 下 危峰 。 木落 层楼 出 ， 天高 一鸟 通 。 鼎湖L 龙 去远 ， 岩壑 自 秋风 。
崆峒L 其二	明	李攀龙	谁道 崆峒L 不 壮游 ， 香垆 春雪 照 凉州L 。 浮云 半插 孤峰 色 ， 落日 长窥 大壑 愁 。 万乘 东还 灵气 歇 ， 诸天 西尽 浊泾 流 。 萧关L 祗在 藤萝 外 ， 客子 风尘 自 白头 。
登 崆峒L	明	唐龙	西北 崆峒L 山势 雄 ， 千年 境界 尚 鸿濛 。 灵泉L 涧引 昆仑L 滴 ， 灏气 光含 青海L 风 。 欲捉 白蟾 飞 树杪 ， 遍寻 元鹤 在 云中 。 荒凉 栋宇 聊 停节 ， 怅望 当年 问道宫 。
游 崆峒L 题	清	安维峻	昔 我戍 沙塞 ， 题诗 灵泉寺L 。 不意 十年 中 ， 公然 履 福地 。 如寻 桃花源 ， 绝境 少人 至 。 又似 蓬莱宫 ， 神仙 可 立致 。 古塔 迥 凌空 ， 中台 巧 位置 。 东西 南北 台 ， 各自 标 灵异 。 琳宫 梵宇 开 ， 瑶草 琪花 闷 。 松柏 高摩 云 ， 群木 如 栉比 。 绝顶 得 攀跻 ， 喘定 神 犹悸 。 连日 骋游 目 ， 穷险 探 奇秘 。
翠屏山L	宋	游师雄	最高 翠屏山L ， 举手 星 可摘 。 珠石 信 团圞 ， 群峰 森 剑戟 。
出塞	唐	王昌龄	秦时T 明月 汉时T 关 ， 万里 长征 人 未还 。 但使 龙城飞将P 在 ， 不教 胡马 度 阴山L 。
李广P	宋	王十朋	李广P 才名 一代 奇 ， 孝文P 犹自 未 深知 。 掇餐 长叹 无 良将 ， 翻惜 将军 不遇 时 。
使 至 塞上	唐	王维	单车 欲 问边 ， 属国 过 居延L 。 征蓬 出 汉塞 ， 归雁 入 胡天 。 大漠 孤烟 直 ， 长河 落日 圆 。 萧关 逢 候吏 ， 都护 在 燕然L 。
调笑令	唐	韦应物	胡马 ， 胡马 ， 远放 燕支山L 下 。 咆沙 咆雪 独嘶 ， 东望 西望 路迷 。 迷路 ， 迷路 ， 边草 无穷 日暮 。
祁连山L	明	陈棐	马上 望 祁连L ， 连峰 高插 天 。 西走 接 嘉峪L ， 凝素 无 青烟 ； 对峰 拱 合黎L ， 遥海 瞰 居延L ； 四时 积雪 明 ， 六月T 飞霜 寒 。 所喜 炎阳 会 ， 雪消 灌 甫田 。 可以 代 雨泽 ； 可以 资 流泉 。 三箭 将军 射 ， 声名 天下 传 。 谁是 挂 弓者 ？ 千年 能 比肩 。
祁连山L	明	郭登	祁连L 高耸 势 岧峣 ， 积素 凝雪 尚未 消 。 色映 晶盐 迷 晓骑 ， 光生 玉树 晃 琼瑶 。 寻梅 腊外 春寒 敛 ， 仗策 吟边 逸兴 飘 。 几度 豪来 诗句 险 ， 恍疑 策蹇 灞陵桥L 。
嘉平月T 护送 参赞 海公P 统军 赴藏	清	和瑛	青海L 诸 蕃道 ， 兼衣 夏月 过 。 冰天 无 汗马 ， 雪峤 有 埋驼 。 地险 达般岭L ， 天通 穆鲁河L 。 噶达苏岭L 老 ， 超蹀 快 如何 。
平蕃 曲 三首 其一	唐	刘长卿	吹角 报 蕃营 ， 回军 欲 洗兵 。 已教 青海L 外 ， 自筑 汉家T 城 。
河湟L 书事 二首 其一	元	马祖常	阴山L 铁骑 角弓 长 ， 閒日 原头 射 白狼 。 青海L 无波 春雁 下 ， 草生 碛里 见 牛羊 。
关山L 篇	北朝	王褒	从军 出 陇坂L ， 驱马 度 关山L 。 关山L 恒 掩蔼 ， 高峰 白云 外 。 遥望 秦川L 水 ， 千里 长 如带 。
过 六盘山L	清	牛树梅	陇山L 何 高高 ， 苍茫 挟云 起 。 会当 绝顶 巅 ， 一目 极 千里 。 翠屏 障 西陲 ， 气势 雄 三辅 。 绵亘 数千 峰 ， 峰峰 藏 云雨 。 日出 照 长安L ， 世事 更 今古 。 借问 道旁 人 ， 何处 题 鹦鹉 。
过 关山L	清	牛树梅	立马 正 峰中 ， 乾坤 一望 通 。 入歌 流水 曲 ， 我唱 大 江东 。 瑞气 迎 关紫 ， 朝暾 透 海红 。 登临 饶 胜概 ， 摩抚 看 衡嵩L 。
鹦鹉	明	李梦阳	鹦鹉 吾乡 物 ， 何时 来 此方 。 绿衣 经雪 短 ， 红嘴 历年 长 。 学语 疑 矜媚 ， 垂头 知 自伤 。 他年 吾 倘遂 ， 归尔 陇山L 阳 。
陇山L 歌送 许天P 玉之官 新安	清	徐乾学	陇山L 高高 陇水L 流 ， 陇西 六月T 如 清秋 。 萧关L 朝那L 近 北地L ， 酒泉L 张掖L 连 凉州L 。 诸葛P 战争 馀 故垒 ， 隗嚣 宫殿 成 荒丘 。 绣衣 按部 求 名马 ， 都护 行营 擢 锦裘 。 数声 羌笛 落梅 怨 ， 一曲 秦筝 边月 愁 。 许侯P 分符 万里 去 ， 晓发 青门L 拥 驺御 。 虞羽P 成名 在 此时 ， 王尊P 叱驭 看 前路 。 京华L 故人 折 杨柳 ， 欲行 不行 日渐 暮 。 我歌 为作 陇山L 词 ， 目极 轮台L 鸟 飞处 。
贺兰山L 图	元	贡师泰	太阴 为峰 雪 为瀑 ， 万里 西来 一方 玉 。 使君 坐对 贺兰L 图 ， 不数 江南 众山 绿 。
夏城L 漫兴	明	李梦阳	行尽 沙陲 又见 河 ， 贺兰L 西望 碧 嵯峨 。 名存 异代 唐渠L 古 ， 云锁 空山 夏寺 多 。 万里 君恩 劳 馈饷 ， 三边 封事 重 干戈 。 朔方 今难 汾阳L 老 ， 谁向 军门 奏 凯歌 。
青铜峡L	清	严禹沛	青铜 峡口L 过 轻舟 ， 百八 亭亭 塔影 浮 。 奇绝 两山 中擘 处 ， 黄河L 千古 自 东流 。
关山L 月	唐	李白	明月 出 天山L ， 苍茫 云海 间 。 长风 几万 里 ， 吹度 玉门关L 。 汉下 白登道L ， 胡窥 青海湾L 。 由来 征 战地 ， 不见 有人 还 。
瑶池L	唐	李商隐	瑶池L 阿母 绮窗 开 ， 黄竹L 歌声 动地 哀 。 八骏 日行 三万里 ， 穆王P 何事 不 重来 ？
天山L 歌	清	洪亮吉	地脉 至此 断 ， 天山L 已 包天 。 日月 何处 栖 ， 总挂 青松 巅 。 峰形 积古 谁 得窥 ， 上有 鸿濛 万年 雪 。 天山L 之石 绿 如 玉 ， 雪 与 石光 皆 染绿 。 半空 石坠 冰 忽开 ， 对面 居然 落 飞瀑 。 我意 长城L 不须 筑 ， 此险 天教 限 沙漠 。
天山L 题壁	清	邓廷桢	叠嶂 摩空 玉色 寒 ， 人随 飞鸟 入 云端 。 蜿蜒 地干 秦关L 远 ， 突兀 天梯 蜀道L 难 。 龙守 南山 冰 万古 ， 马来 西极 石 千盘 。 艰辛 销尽 轮 蹄铁 ， 东指 伊州L 一笑 看 。
经 火山L	唐	岑参	火山L 今 始见 ， 突兀 蒲昌L 东 。 赤焰 烧 虏云 ， 炎氛 蒸 塞空 。 不知 阴阳 炭 ， 何独 烧 此中 ？ 我来 严冬T 时 ， 山下 多 炎风 。 人马 尽 汗流 ， 孰知 造化 工 。
武威L 送 刘判官P 赴 碛西L 行军	唐	岑参	火山L 五月T 行人 少 ， 看君 马去 疾 如 鸟 。 都护 行营 太白L 西 ， 角声 一动 胡天 晓 。
土尔番城L	明	陈诚	路出 榆关L 几十 程 ， 诏书 今到 土番城L 。 九重 雨露 沾 夷狄 ， 一统 山河 属 大明T 。 天上 遥瞻 黄道 日 ， 人间 近识 少微 星 。 姓名 不勒 阴山L 石 ， 愿积 微勋 照 汗青 。
哈密城L	明	陈诚	此地 何由 见 此城 ， 伊州L 哈密L 竟 谁名 ？ 荒村 漠漠 连 天阔 ， 众木 欣欣 向日 荣 。 灵凤 景星 争快 睹 ， 壶浆 箪食 笑 相迎 。 圣恩 广阔 沾 遐尔 ， 夷貊 熙熙 乐 太平 。
哈密L 二首 其一	清	裴景福	天山L 积雪 冻 初融 ， 哈密L 双城 夕照 红 。 十里 桃花 万 杨柳 ， 中原 无此 好 春风 。
哈密L 三首 其二	清	李銮宣	东接 敦煌郡L ， 南连 吐鲁番L 。 咽喉 通 月窟 ， 衣带 俯 河源 。 日影 春城 黯 ， 风声 戍角 喧 。 太平 无 绝檄 ， 中外 一 屏藩 。
抵 哈密L	清	宋伯鲁	万木 伊州L 道 ， 垂条 拂 客车 。 寒城 隐 白雪 ， 古戍 访 黄花 。 铁梗 千年 柳 ， 金盘 五色 瓜 。 回乡 本 饶沃 ， 水木 自 清华 。
伊丽L 河上	清	邓廷桢	万里 伊丽L 水 ， 西流 不 奈何 。 驱车 临 断岸 ， 落木 起 层波 。 远影 群鸥 没 ， 寒声 独雁 过 。 河梁 终 古意 ， 击剑 一 长歌 。
过 赛里木L	清	施补华	西域 之 国 三十六 ， 姑墨 当今 赛里木L 。 刘平国 碑 我 所搜 ， 编入 赵家 金石录 。 永寿T 三年 作 四年 ， 改元 恩诏 阻 遥传 。 龟兹L 乌垒L 长 怀古 ， 策马 亭亭 汉月 圆 。
从军行	唐	王昌龄	青海L 长云 暗 雪山 ， 孤城 遥望 玉门关L 。 黄沙 百战 穿金甲 ， 不破 楼兰L 终不还 。
古 从军行	唐	李颀	白日 登山 望 烽火 ， 昏黄 饮马 傍 交河L 。 行人 刁斗 风砂 暗 ， 公主 琵琶 幽怨 多 。 野营 万里 无 城郭 ， 雨雪 纷纷 连 大漠 。 胡雁 哀鸣 夜夜 飞 ， 胡儿 眼泪 双双 落 。 闻道 玉门L 犹 被遮 ， 应将 性命 逐 轻车 。 年年 战骨 埋 荒外 ， 空见 蒲萄 入 汉家T 。
哈密L 火州城L	明	陈诚	高昌L 旧治 月氏 西 ， 城郭 萧条 市肆 稀 。 遗迹 尚存 唐 制度 ， 居人 争睹 汉T 宫仪 。 梵宫 零落 留 金像 ， 神道 荒凉 卧石 碑 。 征马 不知 风土 异 ， 隔花 犹自 向人 嘶 。
奉天旧宫L	清	颙琰	大政 据 当时 ， 十亭 两翼 张 。 八旗 皆 世胄 ， 一室 汇 宗潢L 。
谒 昭陵L	清	苗君稷	龙蟠 翠嶂 郁 岧峣 ， 路夹 苍松 白玉桥L 。 十二羽林 严 侍卫 ， 风嘶 铁马 白 云霄 。
晓过 大石桥L	清	常纪	夕行 落圆 照 ， 晓行 晨星 多 。 霜华 积 野草 ， 秋水 增 寒波 。 驾言 度 石桥L ， 石桥L 何 峨峨 。 愧非 马相如P ， 今日 复 来过 。
千山L	清	姚元之	明霞 为 饰 玉 为 容 ， 山 到 辽阳L 峦嶂 重 。 欲向 青天 花 数朵 ， 九百九十九 芙蓉 。
寄题 千山L	清	弘历	千山L 胜景 久 芗 哉 ， 三度 徒教 寄 咏回 。 本异 唐宗P 曾 驻辇 ， 空传 丁令P 有 遗台 。 底须 石洞 花岩 到 ， 原匪 探奇 问景 来 。 却笑 前遭 泐崖 处 ， 侵寻 应已 漶 莓苔 。
辽城L 望月	唐	李世民	玄兔L 月初 明 ， 澄辉 照 辽碣 。 映云 光 暂隐 ， 隔树 花 如缀 。 魄满 桂枝 圆 ， 轮亏 镜彩 缺 。 临城 却 影散 ， 带晕 重 围结 。 驻跸 俯 九都 ， 停观 妖氛 灭 。
杜不见	唐	沈佺期	卢家 少妇 郁 金堂 ， 海燕 双栖 玳瑁 梁 。 九月T 寒砧 催 木叶 ， 十年 征戍 忆 辽阳L 。 白狼河L 北 音书 断 ， 丹凤城L 南 秋夜 长 。 谁谓 含愁 独不见 ， 更教 明月 照 流黄 。
辽阳城L	清	锡珍	忆 从 东国L 经 行处 ， 千里 王程 尽 叆江L 。 疆域 虽殊 风景 似 ， 万山 不断 到 辽阳L 。
辽阳 怀古	清	弘历	唐宗P 战垒 久 成功 ， 管邴P 曾闻 度 海东L 。 只有 千年 华表 鹤 ， 时看 来往 白云 中 。
医巫闾山L	金	蔡圭	幽州L 北镇 高 且 雄 ， 倚天 万仞 蟠天 东 。 祖龙P 力驱 不肯 去 ， 至今 鞭血 馀 殷红 。 崩崖 暗谷 森云 树 ， 萧寺 门横 入山 路 。 谁道 营丘P 笔 有神 ， 只得 峰峦 两三 处 。 我方 万里 来 天涯 ， 坡陁 缭绕 昏 风沙 。 直教 眼界 增 明秀 ， 好在 岚光 日夕 佳 。 封龙 山边 生处 乐 ， 此山 之间 亦 不恶 。 他年 南北 两 生涯 ， 不妨 世有 扬州L 鹤 。
松花江L 放船歌	清	玄烨	松花江L ， 江水 清 ， 夜来 雨过 春涛 生 。 浪花 叠 锦绣 觳明 ， 彩帆 画鹢 随风 轻 。 箫韶 小奏 中流 鸣 ， 苍岩 翠壁 两岸 横 。 浮云 耀日 何 晶晶 ， 乘流 直下 蛟龙 惊 。 连樯 接舰 屯 江城L ， 貔貅 健甲 皆 锐精 。 旌旄 映水 翻 朱缨 ， 我来 问俗 非 观兵 。 松花江L ， 江水 清 ， 浩浩 瀚瀚 冲波 行 。
乌拉L 怀古	清	成多禄	虎踞 龙蟠 拱 上京 ， 当年 雄长 此间 争 。 狼烟 已靖 孤城 在 ， 乌拉L 犹存 四部 名 。 断垒 十年 摇树 色 ， 大江 三面 走 秋声 。 老来 别有 兴亡 感 ， 不向 西风 诉 不平 。
驻跸 吉林L 境 望叩 长白山L	清	弘历	吉林L 真 吉林 ， 长白 郁 嵚岑 。 作镇 曾闻 古 ， 钟祥 亦 匪今 。 邠岐L 径处 远 ， 云雾 望中 深 。 天作 心 常忆 ， 明禋 志倍 钦 。
长白山L	清	吴兆骞	长白L 雄 东北L ， 嵯峨 俯 塞州 。 迥临 沧海 曙 ， 独峙 大荒秋 。 白雪 横 千嶂 ， 青天 泻 二流 。 登封 如 可作 ， 应待 翠华 游 。
墨河L	元	达不花	墨河L 万里 金 沙漠 ， 世祖P 深思 创业 难 。 却望 阑干 护 青草 ， 丹墀 留与 子孙 看 。
题 黑龙江L	清	林传甲	北望 黑龙江L 水浑 ， 江东 六十四 旗屯 。 那堪 庚子T 干戈 后 ， 犹赖 咸丰L 旧约 存 。 破碎 河山 余 四壁 ， 流离 道路 掩 重门 。 边陲 至计 非 勤远 ， 何事 南迁 墨尔根L 。
镜泊L 歌	清	陈大文	神山 耸 碧落 ， 迤逦 赴 万壑 。 灵辟 川原 幽 ， 岩岩 涨 喷薄 ， 白波 浩荡 堆 琉璃 ， 琉璃 空明 汇 镜泊L 。 齐州 渺 九点 ， 一气 望 鸿濛 。 乃知 长白之山L 自 天作 ， 镜泊L 之水 自 天凿 。 天开 灵境 幻冥 搜 ， 烟雾 盘抱 空中 楼 。 一曲 绿水 歌 未休 ， 水波 明朗 鉴 千秋 。
兴安岭L 绝顶 远眺	清	查慎行	舆图 远辟 古 兴安L ， 凤舞 龙回 气郁 蟠 。 半岭 出云 铺 大漠 ， 乔松 落叶 倚 高寒 。 丹青 不数 东南 秀 ， 俯仰 方知 覆载 宽 。 万里 乾坤 千里 目 ， 欣 从 奇险 得 奇观 。
宁古塔L 杂诗 其三	清	杨宾	黑水新城L 近 ， 黄龙旧府L 遥 。 家传 肃慎P 矢 ， 人煖 挹娄P 貂 。 残雪 埋 松塔 ， 微风 变 柳条 。 春明 二三月 ， 也复 种 青苗 。
台湾L 吟	清	黄学明	四溟 中断 此 孤悬 ， 日月 轮高 见 影偏 。 泣泪 鲛人 朝 入市 ， 凝寒 金气 夜 干天 。 马鞍 矗起 青 全岛 ， 鹿耳L 雄开 障 百川 。 盛气 消沉 无觅处 ， 牛羊来下 翠岩 烟 。
台阳L 杂兴	清	马清枢	岩穴 曾栖 宋T 客星 ， 胜朝 事势 等 零丁L 。 骑鲸人 去 天 难问 ， 梦蝶园L 荒 酒 易醒 ； 满树 花开 三友白 ， 孤坟 草为 五妃 青 ； 哀蝉 似诉 王孙 恨 ， 暮雨 萧萧 不忍 听 。
抵 台湾L	清	孙元衡	浪言 矢志 在 澄清 ， 博得 天涯 汗漫 行 。 山势 北盘 乌鬼渡L ， 潮声 南吼 赤嵌城L 。 眼明 象外 三千界 ， 肠转 人间 十二更 。 我 与 苏髯P 同 不恨 ， 兹游 奇绝 冠 平生 。
台阳L 竹枝词	清	林树海	阿侬 生小 住 台湾L ， 不羡 蓬壶 飘渺 间 。 愿借 一帆 好 风力 ， 随即 西渡 到 唐山L 。
谒 延平王庙L	清	蔡醒甫	沙仙 纷纷 列 舳舻 ， 当年 海上 拓雄 图 。 鲸鱼 入梦 生 何异 ， 龙种 偕来 类 不孤 。 人似 武乡 等 北伐 ， 地同 洛邑L 建 东都L 。 也知 矢志 延明祚L ， 绝岛 偏安 亦 丈夫 。
寄题 延平王庙L 壁 其一	清	吴子光	曾读 丰碑 渤澥L 东 ， 开疆 犹仰 大王 风 。 阖门 骨肉 杯羹 底 ， 千里 江山 锦绣 中 。 明代T 兴亡 归劫 数 ， 史家 成败 论 英雄 。 似闻 鹿耳L 鲲身 畔 ， 呜咽 潮声 早晚 同 。
玉山L 歌	清	陈梦林	须弥山L 北 水晶宫 ， 天开 图画 自 玲珑 。 不知 何年 飞海 东 ， 幻成 三个 玉 芙蓉 。 庄严 色相 俨 三公 ， 皓白 须眉 冰雪 容 。 夹辅 日月 柱 穹窿 ， 俯视 众山 皆 群工 。 帝天 不许 俗尘 通 ， 四时 长遣 白云 封 。 偶然 一见 杳难 逢 ， 唯有 霜寒 月 在冬 。 自古 未有 登 其峰 ， 於戏 虽欲 从之 将 焉 从 。
咏 水沙连L 其一	清	黄叔璥	水沙连L 在 万山 中 ， 一屿 环湖 映 碧空 。 员顶 净明 傍作 屋 ， 渡头 烟火 小舟 通 。
太古巢L	清	陈维英	山中 甲子T 不知 年 ， 梦入 华胥 一 枕边 。 埌土 原无 盘 古墓 ， 枯枝 独辟 有 巢天 。 两仪石L 上 搜 遗迹 ， 八卦潭L 前 隐 散仙 。 自笑 草庐 开 混沌 ， 结绳 坐对 屋 三椽 。
赤嵌城L	清	齐体物	特立 巍巍 控 太清 ， 烟霞 都自 脚根 生 。 羞为 白发 蛮 官长 ， 亲上 红毛 赤嵌城L 。 日月 过天 疑 见碍 ， 鱼龙 骇影 尽 潜惊 。 何堪 望断 他乡 目 ， 沧海 茫茫 故国 情 。
登 赤嵌城L 远眺	清	陈辉	鹿耳L 鲲身L 翠屿 连 ， 云光 海色 雨 晴天 。 江帆 晓渡 波间 影 ， 市宅 寒炊 竹外 烟 。 山似 画屏 时 染黛 ， 水如 冰镜 日 磨鲜 。 凭高 得趣 閒 瞻眺 ， 万里 乡关 一望 悬 。
红毛楼L	清	宋永清	东西 遥对 海疆 秋 ， 高接 云虚 尺 五楼 。 百户 千窗 迷 野草 ， 贺兰L 曾作 万年 谋 。